County,Precinct,Biden VBM,Biden EV,Biden ED,Ossoff VBM,Ossoff EV,Ossoff ED,Registered Voters,Trump Election Day Votes,Trump Advanced Voting Votes,Trump Absentee by Mail Votes,Trump Provisional Votes,Trump Total Votes,Biden Election Day Votes,Biden Advanced Voting Votes,Biden Absentee by Mail Votes,Biden Provisional Votes,Biden Total Votes,Registered Voters,Perdue Election Day Votes,Perdue Advanced Voting Votes,Perdue Absentee by Mail Votes,Perdue Provisional Votes,Perdue Total Votes,Ossoff Election Day Votes,Ossoff Advanced Voting Votes,Ossoff Absentee by Mail Votes,Ossoff Provisional Votes,Ossoff Total Votes
Appling,1B,26.80%,8.90%,8.30%,28.20%,11.00%,11.00%,1309,253,493,123,1,870,23,48,45,0,116,1309,241,469,117,1,828,30,58,46,0,134
Appling,1C,13.30%,4.90%,8.20%,13.50%,4.70%,9.00%,848,178,349,65,2,594,16,18,10,0,44,848,170,343,64,2,579,17,17,10,0,44
Appling,2,78.20%,59.90%,52.60%,77.00%,59.40%,54.40%,2251,145,305,81,0,531,159,456,291,2,908,2251,136,299,79,0,514,160,437,265,2,864
Appling,3A1,12.30%,2.00%,2.10%,14.70%,2.40%,3.40%,793,232,291,64,0,587,5,6,9,0,20,793,225,287,58,0,570,8,7,10,0,25
Appling,3C,45.30%,17.40%,33.50%,45.10%,18.00%,32.70%,1566,107,608,128,0,843,54,128,106,0,288,1566,103,593,123,0,819,50,130,101,0,281
Appling,4B,12.00%,3.00%,1.20%,11.30%,3.70%,1.60%,866,253,321,73,0,647,3,10,10,0,23,866,252,316,71,0,639,4,12,9,0,25
Appling,4D,20.20%,9.70%,7.70%,21.50%,9.60%,8.10%,1493,240,649,158,1,1048,20,70,40,0,130,1493,236,634,150,1,1021,21,67,41,0,129
Appling,5A,28.10%,11.70%,11.70%,31.10%,11.70%,12.00%,1147,142,453,100,2,697,18,60,39,1,118,1147,137,437,84,2,660,18,58,38,1,115
Appling,5B,27.40%,12.70%,14.90%,26.60%,13.00%,18.90%,1126,203,405,98,3,709,36,59,37,0,132,1126,186,396,91,3,676,44,59,33,0,136
Atkinson,1,32.40%,11.40%,12.00%,33.60%,11.60%,12.70%,1802,235,716,75,0,1026,32,92,36,0,160,1802,226,707,75,0,1008,33,93,38,0,164
Atkinson,2,12.90%,5.90%,11.40%,10.30%,8.20%,10.00%,742,194,257,27,1,479,25,16,4,0,45,742,189,245,26,1,461,21,22,3,0,46
Atkinson,3,46.90%,31.30%,34.30%,46.90%,30.50%,31.10%,1311,224,299,43,0,566,117,136,38,0,291,1311,226,296,43,0,565,102,130,38,0,270
Atkinson,4,73.20%,57.80%,54.70%,62.90%,56.20%,48.50%,944,63,147,19,0,229,76,201,52,0,329,944,68,144,26,0,238,64,185,44,0,293
Bacon,DOUGL,28.70%,8.50%,24.60%,28.70%,8.30%,23.50%,6720,431,3099,487,1,4018,140,288,196,1,625,6720,417,3047,465,0,3929,127,276,187,1,591
Baker,A,70.60%,20.60%,16.40%,75.00%,18.20%,13.70%,166,60,27,5,1,93,12,7,12,0,31,166,62,27,4,1,94,10,6,12,0,28
Baker,E,69.50%,51.50%,31.20%,71.30%,52.80%,30.30%,401,52,63,25,1,141,24,67,57,0,148,401,52,60,23,1,136,23,67,57,0,147
Baker,H,67.80%,39.80%,43.00%,71.20%,41.30%,44.90%,351,45,56,19,0,120,34,37,40,0,111,351,43,54,17,0,114,35,38,42,0,115
Baker,M,53.50%,24.30%,31.20%,51.30%,24.60%,30.40%,270,64,53,20,0,137,29,17,23,0,69,270,64,52,19,0,135,28,17,20,0,65
Baker,N,59.60%,34.60%,41.70%,59.30%,36.00%,41.90%,1070,70,267,69,0,406,50,141,102,0,293,1070,68,258,68,0,394,49,145,99,0,293
Baldwin,CTY1,84.20%,73.90%,71.70%,85.10%,73.40%,68.00%,1259,36,108,35,0,179,91,306,186,0,583,1259,41,109,32,0,182,87,301,183,0,571
Baldwin,CTY2,74.10%,67.60%,61.50%,74.50%,65.70%,59.60%,957,40,72,41,0,153,63,150,117,1,331,957,42,74,37,0,153,61,142,108,1,312
Baldwin,CTY3,88.90%,76.20%,78.40%,87.40%,74.80%,76.90%,1381,36,77,21,0,134,131,247,169,0,547,1381,39,80,23,0,142,130,238,159,0,527
Baldwin,CTY4,82.70%,51.70%,48.20%,79.20%,52.10%,51.80%,506,29,70,14,0,113,27,75,67,0,169,506,27,70,16,0,113,29,76,61,0,166
Baldwin,CTY5,89.10%,72.30%,69.20%,86.90%,70.90%,69.40%,1481,41,140,31,0,212,92,365,254,0,711,1481,38,143,37,0,218,86,349,246,0,681
Baldwin,CTY6,63.80%,47.40%,51.30%,61.90%,45.90%,51.10%,2211,128,519,145,1,793,136,468,255,0,859,2211,129,527,146,1,803,136,448,237,0,821
Baldwin,MERI,52.30%,34.90%,30.70%,49.90%,33.90%,31.20%,2832,257,892,217,0,1366,114,479,238,0,831,2832,247,890,222,0,1359,112,456,221,0,789
Baldwin,MONT,60.80%,37.70%,37.50%,59.50%,37.40%,38.40%,3826,292,1074,215,0,1581,175,651,333,0,1159,3826,284,1062,215,0,1561,177,634,316,0,1127
Baldwin,1714,65.50%,33.50%,30.30%,66.70%,34.50%,31.30%,1101,135,238,50,3,426,60,120,95,0,275,1101,129,230,45,3,407,60,121,90,0,271
Baldwin,318,53.10%,24.60%,22.30%,52.40%,23.60%,23.50%,3515,311,1324,256,0,1891,89,431,290,0,810,3515,300,1332,250,0,1882,92,412,275,0,779
Baldwin,319,66.40%,39.30%,38.80%,64.70%,38.90%,36.30%,1862,170,461,100,0,731,108,298,198,0,604,1862,174,458,103,0,735,99,291,189,0,579
Baldwin,321E,88.00%,75.50%,72.90%,86.20%,76.00%,72.00%,1313,46,69,25,0,140,124,213,183,0,520,1313,47,65,27,0,139,121,206,169,0,496
Baldwin,321W,87.40%,71.70%,79.30%,86.50%,70.60%,77.30%,2903,68,260,72,0,400,261,660,500,0,1421,2903,73,264,74,0,411,249,633,475,0,1357
Baldwin,322,62.80%,25.60%,16.50%,62.80%,24.30%,18.20%,1574,284,432,68,0,784,56,149,115,0,320,1574,275,429,64,0,768,61,138,108,0,307
Banks,1,31.10%,7.40%,3.40%,28.90%,7.40%,5.20%,1533,224,575,102,0,901,8,46,46,0,100,1533,217,563,101,1,882,12,45,41,0,98
Banks,2,25.30%,11.70%,17.90%,28.20%,13.20%,19.20%,876,87,317,124,0,528,19,42,42,0,103,876,84,308,112,0,504,20,47,44,0,111
Banks,3,23.50%,8.90%,4.20%,15.20%,9.00%,6.50%,415,45,194,26,1,266,2,19,8,0,29,415,42,192,28,1,263,3,19,5,0,27
Banks,4,19.30%,6.80%,6.90%,24.10%,6.70%,5.70%,816,121,300,46,1,468,9,22,11,0,42,816,115,294,41,1,451,7,21,13,0,41
Banks,5,16.70%,5.20%,7.10%,16.70%,4.10%,5.90%,363,65,163,30,0,258,4,9,6,1,20,363,64,164,30,0,258,4,7,6,0,17
Banks,6,30.40%,10.40%,9.20%,29.10%,9.60%,9.80%,1977,243,732,128,4,1107,25,85,56,0,166,1977,236,727,122,4,1089,26,77,50,0,153
Banks,7,31.10%,8.60%,11.30%,33.00%,8.00%,11.30%,1008,126,341,71,0,538,14,32,32,2,80,1008,126,345,67,0,538,14,30,33,2,79
Banks,8,12.20%,5.70%,10.00%,10.70%,6.50%,10.50%,600,90,232,65,0,387,10,14,9,0,33,600,85,229,67,0,381,10,16,8,0,34
Banks,9,35.80%,6.10%,5.40%,36.50%,6.20%,4.60%,667,86,293,52,1,432,5,19,29,0,53,667,82,288,47,1,418,4,19,27,0,50
Banks,10,24.00%,7.20%,10.20%,23.80%,6.80%,10.10%,1544,176,666,114,1,957,20,52,36,0,108,1544,169,658,109,1,937,19,48,34,0,101
Banks,11,20.00%,6.60%,8.20%,19.30%,6.30%,8.70%,1775,224,732,164,1,1121,20,52,41,0,113,1775,220,720,159,1,1100,21,48,38,0,107
Banks,12,25.40%,8.10%,9.90%,26.50%,8.30%,9.80%,704,81,306,50,1,438,9,27,17,0,53,704,82,299,50,1,432,9,27,18,0,54
Banks,13,17.20%,5.70%,6.20%,14.00%,5.80%,3.90%,620,76,265,53,0,394,5,16,11,0,32,620,73,261,49,0,383,3,16,8,0,27
Barrow,1,43.20%,21.60%,17.60%,41.70%,21.20%,18.30%,3359,491,1000,237,0,1728,105,275,180,0,560,3359,472,988,232,0,1692,106,266,166,0,538
Barrow,2,36.40%,14.30%,15.50%,34.30%,13.70%,16.30%,6784,753,2585,695,0,4033,137,430,398,1,966,6784,740,2566,686,0,3992,143,408,358,1,910
Barrow,3,40.80%,19.50%,17.40%,40.00%,19.00%,17.60%,6364,886,1717,494,1,3098,187,416,340,0,943,6364,863,1685,465,1,3014,184,394,310,0,888
Barrow,4,43.80%,19.90%,20.00%,41.50%,19.40%,21.80%,4012,443,1178,283,0,1904,111,292,221,0,624,4012,430,1174,279,0,1883,120,282,198,0,600
Barrow,5,50.70%,24.20%,21.90%,49.80%,23.30%,22.80%,8336,946,2635,617,0,4198,265,843,635,0,1743,8336,907,2628,610,0,4145,268,797,605,0,1670
Barrow,8,40.50%,18.50%,19.00%,39.90%,17.60%,20.90%,7009,725,2506,553,0,3784,170,568,376,0,1114,7009,683,2480,528,0,3691,180,529,351,0,1060
Barrow,13,51.10%,30.80%,34.00%,50.20%,31.00%,35.60%,9393,675,2392,597,0,3664,348,1065,623,0,2036,9393,652,2348,579,0,3579,361,1054,583,0,1998
Barrow,16,55.20%,31.30%,29.00%,54.20%,31.10%,30.00%,10348,966,2769,658,2,4395,394,1261,810,2,2467,10348,938,2737,645,1,4321,400,1236,763,3,2402
Bartow,1,39.60%,14.80%,14.20%,38.50%,14.70%,15.10%,6995,819,2476,523,1,3819,135,429,343,1,908,6995,794,2427,512,1,3734,140,419,320,1,880
Bartow,2,50.50%,20.40%,17.90%,50.30%,20.70%,18.00%,4729,569,1158,270,0,1997,124,297,275,0,696,4729,551,1119,256,0,1926,121,292,259,0,672
Bartow,3,51.10%,28.10%,34.50%,50.00%,28.00%,35.30%,6805,539,1726,544,1,2810,284,675,568,0,1527,6805,526,1710,530,1,2767,288,666,531,0,1485
Bartow,4,47.10%,24.50%,29.50%,43.80%,23.30%,28.20%,8129,571,2722,737,0,4030,238,882,655,1,1776,8129,560,2724,756,0,4040,219,829,589,1,1638
Bartow,5,46.60%,23.60%,24.10%,45.20%,24.40%,25.60%,4588,424,1267,566,2,2259,133,391,493,2,1019,4588,403,1233,554,2,2192,136,399,457,3,995
Bartow,6,35.60%,16.70%,13.10%,35.80%,16.10%,13.90%,4007,680,1235,395,2,2312,103,247,218,0,568,4007,662,1238,380,2,2282,107,237,212,0,556
Bartow,7,39.90%,16.60%,14.10%,39.80%,15.70%,13.60%,3122,582,741,258,1,1582,96,147,171,0,414,3122,575,739,253,1,1568,91,138,167,0,396
Bartow,8,48.10%,18.30%,15.90%,46.90%,18.30%,17.00%,5322,853,1661,343,2,2859,162,373,318,0,853,5322,828,1630,338,1,2797,170,364,298,0,832
Bartow,9,26.30%,11.80%,5.20%,24.30%,11.70%,5.50%,1448,419,360,118,0,897,23,48,42,0,113,1448,409,356,112,0,877,24,47,36,0,107
Bartow,10,41.70%,18.60%,19.80%,40.20%,18.50%,19.60%,6598,710,2164,354,0,3228,174,493,253,1,921,6598,703,2135,348,0,3186,171,485,234,0,890
Bartow,11,30.80%,13.40%,13.20%,24.80%,12.90%,12.40%,2674,638,683,229,0,1550,97,106,102,0,305,2674,634,679,230,0,1543,90,101,76,0,267
Bartow,12,43.40%,21.00%,19.70%,43.30%,21.40%,20.40%,4012,437,1291,338,4,2070,107,344,259,1,711,4012,423,1271,327,3,2024,107,347,250,2,706
Bartow,14,24.60%,11.90%,7.60%,22.80%,12.00%,8.70%,2132,653,513,202,1,1369,54,69,66,0,189,2132,629,504,200,1,1334,60,69,59,0,188
Bartow,15,23.70%,7.60%,7.00%,21.30%,7.90%,8.50%,2829,794,813,254,0,1861,60,67,79,0,206,2829,779,800,251,0,1830,72,69,68,0,209
Bartow,16,29.60%,12.30%,9.70%,30.00%,11.70%,10.20%,2723,660,752,235,1,1648,71,105,99,0,275,2723,643,752,229,1,1625,73,100,98,0,271
Bartow,17,48.50%,29.90%,34.00%,47.00%,30.80%,35.10%,6431,520,1444,454,4,2422,268,617,427,2,1314,6431,498,1400,435,4,2337,270,622,385,2,1279
Bartow,18,43.10%,21.20%,12.80%,41.70%,21.40%,14.00%,1865,311,493,156,1,961,46,133,118,0,297,1865,300,492,154,1,947,49,134,110,0,293
Ben Hill,1,70.10%,41.20%,50.50%,67.70%,40.40%,52.90%,3956,156,936,156,1,1249,160,656,366,0,1182,3956,146,945,158,0,1249,163,640,331,1,1135
Ben Hill,2,48.30%,23.70%,38.20%,48.80%,22.60%,38.40%,5898,285,2204,372,0,2861,176,686,348,0,1210,5898,281,2198,349,0,2828,175,641,333,0,1149
Berrien,11062,18.20%,9.40%,5.10%,22.20%,9.70%,5.70%,999,337,278,90,1,706,18,29,20,0,67,999,327,270,84,1,682,20,29,24,0,73
Berrien,1144,34.90%,11.40%,17.60%,33.30%,12.00%,17.90%,1946,337,599,125,1,1062,72,77,67,0,216,1946,321,582,124,1,1028,70,79,62,0,211
Berrien,1157,35.10%,12.90%,17.70%,32.30%,12.50%,16.50%,6079,551,2444,396,2,3393,118,361,214,1,694,6079,551,2406,386,2,3345,109,343,184,0,636
Berrien,1642,24.50%,9.50%,10.40%,23.10%,9.50%,11.70%,1111,323,237,71,5,636,38,25,23,0,86,1111,306,237,70,4,617,40,25,21,1,87
Berrien,518,39.10%,22.20%,23.20%,38.50%,21.40%,23.00%,1140,287,267,67,1,622,87,76,43,0,206,1140,284,265,64,1,614,85,72,40,0,197
Bibb,EM1,94.50%,96.60%,94.00%,93.50%,96.20%,95.10%,2108,15,13,19,0,47,228,369,326,6,929,2108,11,14,21,1,47,228,357,301,5,891
Bibb,EM2,93.00%,94.30%,91.50%,93.50%,92.80%,89.80%,3932,40,60,56,1,157,431,984,746,8,2169,3932,49,74,50,0,173,425,952,717,7,2101
Bibb,EM3,79.40%,70.50%,70.40%,79.80%,68.70%,69.80%,3494,127,303,140,0,570,296,723,538,6,1563,3494,126,314,128,2,570,292,690,507,4,1493
Bibb,EM4,95.30%,93.40%,90.40%,94.60%,92.50%,90.70%,2280,36,35,23,1,95,342,497,465,5,1309,2280,34,39,25,1,99,337,482,440,5,1264
Bibb,EM5,82.70%,77.10%,68.10%,82.00%,77.40%,69.20%,2552,116,169,93,1,379,249,569,445,1,1264,2552,113,163,92,0,368,252,558,420,2,1232
Bibb,GF1,93.80%,89.70%,85.30%,92.90%,89.00%,83.50%,6283,93,165,66,2,326,546,1436,1001,4,2987,6283,104,173,72,1,350,524,1393,945,6,2868
Bibb,GF2,93.10%,88.70%,84.90%,92.90%,88.40%,85.00%,2158,36,43,19,0,98,202,336,256,1,795,2158,35,42,18,0,95,198,321,236,1,756
Bibb,GF3,92.60%,88.70%,88.80%,90.40%,88.70%,89.30%,3292,48,91,36,0,175,373,713,451,6,1543,3292,44,89,44,0,177,362,699,414,5,1480
Bibb,GF4,90.00%,82.20%,85.70%,87.50%,83.10%,84.30%,2231,41,69,29,0,139,243,319,262,2,826,2231,44,64,33,0,141,234,315,230,2,781
Bibb,GF5,86.50%,90.20%,87.80%,84.90%,90.10%,86.40%,4761,85,118,98,0,301,610,1085,629,4,2328,4761,94,117,105,0,316,592,1061,592,4,2249
Bibb,HA1,86.40%,87.80%,89.40%,86.20%,87.00%,90.30%,3377,52,102,77,1,232,444,737,491,4,1676,3377,47,107,75,1,230,443,719,470,3,1635
Bibb,HA2,66.00%,61.40%,43.70%,65.20%,61.30%,45.00%,4173,493,500,218,4,1215,382,797,423,4,1606,4173,476,496,215,4,1191,390,784,403,3,1580
Bibb,HA3,80.70%,71.90%,65.60%,81.00%,71.70%,65.70%,7068,280,666,248,7,1201,535,1701,1035,13,3284,7068,276,664,234,5,1179,526,1683,996,12,3217
Bibb,HA4,58.40%,40.70%,32.50%,57.40%,39.90%,34.30%,4745,556,1159,395,2,2112,266,795,554,3,1618,4745,540,1165,388,3,2096,281,772,522,2,1577
Bibb,HO1,46.80%,33.10%,28.20%,42.10%,31.40%,26.80%,3436,366,904,456,1,1727,141,447,401,3,992,3436,374,916,486,1,1777,135,420,354,2,911
Bibb,HO2,45.60%,32.80%,24.70%,43.10%,32.50%,25.60%,3394,405,905,423,1,1734,129,441,355,4,929,3394,406,907,426,1,1740,136,436,323,4,899
Bibb,HO3,60.50%,45.60%,38.20%,57.30%,44.50%,38.50%,6397,572,1320,502,3,2397,354,1108,769,2,2233,6397,570,1333,527,1,2431,355,1069,706,3,2133
Bibb,HO4,62.30%,48.10%,49.00%,60.60%,47.80%,47.10%,1711,124,335,118,0,577,118,311,195,1,625,1711,128,334,122,0,584,113,306,188,1,608
Bibb,HO5,68.50%,64.50%,56.70%,66.30%,63.30%,56.50%,2272,175,261,98,1,535,227,474,213,3,917,2272,171,260,100,1,532,220,448,197,3,868
Bibb,HO6,55.10%,43.30%,39.90%,53.80%,42.20%,38.90%,2213,196,493,183,6,878,128,377,225,6,736,2213,199,499,181,5,884,124,365,211,6,706
Bibb,HO7,56.10%,31.90%,26.50%,54.00%,31.40%,26.60%,2897,371,770,279,1,1421,132,361,356,2,851,2897,374,773,286,1,1434,134,354,336,2,826
Bibb,RU1,52.60%,45.50%,23.20%,52.10%,46.00%,23.80%,5704,917,1146,494,2,2559,276,958,549,1,1784,5704,907,1125,478,1,2511,280,958,519,3,1760
Bibb,RU2,49.50%,40.40%,20.70%,49.50%,41.00%,21.50%,3409,692,646,248,4,1590,179,438,243,3,863,3409,678,630,235,3,1546,183,437,230,4,854
Bibb,VV1,79.60%,66.60%,60.10%,76.60%,65.80%,60.00%,3572,179,351,137,3,670,272,701,534,2,1509,3572,179,353,149,3,684,271,679,487,2,1439
Bibb,VV2,87.40%,73.80%,65.60%,85.40%,71.50%,65.60%,2067,103,135,52,1,291,198,380,361,0,939,2067,103,144,58,1,306,198,362,339,0,899
Bibb,VV3,91.50%,90.90%,91.80%,91.00%,90.20%,91.10%,3127,28,75,49,1,153,321,749,526,5,1601,3127,30,79,49,1,159,312,724,493,5,1534
Bibb,VV4,92.80%,85.60%,86.10%,90.70%,84.50%,85.20%,4097,81,151,49,2,283,509,899,627,7,2042,4097,87,160,60,0,307,491,873,584,8,1956
Bibb,VV5,58.50%,44.00%,40.50%,54.80%,43.30%,40.40%,2359,213,503,197,0,913,143,395,278,2,818,2359,212,507,208,0,927,142,387,252,2,783
Bibb,VV6,58.50%,44.00%,40.50%,54.80%,43.30%,40.40%,3021,280,451,204,2,937,201,524,450,5,1180,3021,278,462,226,3,969,189,498,397,4,1088
Bibb,WA1,58.50%,44.00%,40.50%,54.80%,43.30%,40.40%,2617,616,503,179,2,1300,131,295,247,2,675,2617,618,496,179,2,1295,131,292,233,2,658
Bibb,WA2,58.50%,44.00%,40.50%,54.80%,43.30%,40.40%,3232,586,792,190,5,1573,98,465,313,1,877,3232,564,776,183,4,1527,106,470,304,2,882
Bleckley,1,41.10%,17.50%,23.80%,38.80%,17.30%,23.80%,0,942,2770,614,2,4328,295,588,428,0,1311,0,931,2745,603,2,4281,292,574,383,0,1249
Brantley,1,16.30%,5.10%,6.70%,14.60%,5.30%,7.30%,3394,642,1326,242,0,2210,46,71,47,0,164,3394,624,1295,239,0,2158,49,73,41,0,163
Brantley,2,19.50%,8.80%,7.00%,18.30%,8.20%,7.50%,4208,553,1709,256,4,2522,41,164,62,1,268,4208,530,1683,246,4,2463,42,151,55,1,249
Brantley,3,33.70%,8.20%,6.80%,34.60%,8.10%,8.50%,4286,797,1272,187,3,2259,58,114,95,0,267,4286,770,1240,178,3,2191,72,110,94,0,276
Brooks,1199,81.20%,51.90%,53.80%,77.10%,49.30%,51.30%,4117,179,598,127,4,908,210,646,547,3,1406,4117,185,613,145,4,947,196,597,488,3,1284
Brooks,1230,54.70%,30.90%,11.40%,53.80%,30.80%,11.60%,350,100,56,24,1,181,13,25,29,0,67,350,98,54,24,1,177,13,24,28,0,65
Brooks,1402,82.60%,43.00%,35.50%,82.90%,40.50%,34.00%,1066,131,195,37,0,363,71,147,176,1,395,1066,132,200,35,0,367,67,136,170,1,374
Brooks,1650,48.70%,16.20%,14.70%,48.60%,16.60%,15.70%,2317,383,631,134,0,1148,66,122,127,0,315,2317,370,623,128,0,1121,69,124,121,0,314
Brooks,659,45.70%,13.20%,11.30%,45.20%,14.10%,12.10%,735,171,211,38,1,421,22,32,32,0,86,735,166,207,34,1,408,23,34,28,0,85
Brooks,660,57.20%,22.80%,23.40%,53.30%,22.80%,22.30%,1962,305,502,118,0,925,93,148,158,0,399,1962,303,499,120,0,922,87,147,137,0,371
Brooks,1712,52.90%,19.60%,23.40%,45.80%,18.30%,25.40%,607,154,119,41,0,314,47,29,46,0,122,607,147,116,45,0,308,50,26,38,0,114
Bryan,1,46.90%,31.40%,32.20%,45.90%,31.30%,31.70%,2653,240,742,129,0,1111,114,339,114,0,567,2653,235,729,125,0,1089,109,332,106,0,547
Bryan,10,52.10%,20.30%,18.50%,52.40%,19.50%,17.30%,2291,233,822,158,0,1213,53,210,172,0,435,2291,229,817,147,0,1193,48,198,162,0,408
Bryan,2,44.70%,15.70%,13.10%,44.70%,15.50%,14.60%,2341,385,795,119,1,1300,58,148,96,0,302,2341,367,786,114,1,1268,63,144,92,0,299
Bryan,3,39.00%,17.50%,21.00%,38.60%,18.40%,21.20%,2995,346,934,161,1,1442,92,198,103,0,393,2995,344,911,154,1,1410,93,205,97,0,395
Bryan,4,75.10%,36.70%,26.30%,72.80%,37.20%,29.80%,1974,181,469,66,1,717,64,272,199,1,536,1974,169,455,69,1,694,71,269,185,1,526
Bryan,5,67.90%,38.30%,35.00%,68.10%,37.40%,36.60%,3264,205,797,134,1,1137,111,494,283,0,888,3264,200,791,126,1,1118,116,473,269,0,858
Bryan,6,50.40%,20.20%,20.40%,46.70%,19.30%,21.30%,2885,152,1300,202,0,1654,39,329,205,0,573,2885,148,1301,209,0,1658,40,311,183,0,534
Bryan,7,62.70%,25.60%,23.80%,60.30%,24.20%,22.50%,4270,307,1697,201,0,2205,96,583,338,0,1017,4270,310,1711,205,0,2226,90,547,311,0,948
Bryan,8,55.70%,31.50%,27.00%,54.00%,31.10%,29.00%,5365,327,1877,324,0,2528,120,865,407,1,1393,5365,318,1862,321,0,2501,129,840,377,1,1347
Bryan,9,66.70%,35.80%,30.80%,66.20%,36.70%,32.40%,2570,203,639,94,1,937,91,356,188,0,635,2570,198,620,92,0,910,94,360,180,1,635
Bulloch,1,63.60%,32.30%,14.90%,67.10%,32.90%,15.00%,720,244,107,32,2,385,43,51,56,0,150,720,242,106,27,1,376,43,52,55,0,150
Bulloch,10,49.60%,30.60%,21.70%,48.30%,30.60%,19.60%,3360,543,833,243,1,1620,150,367,239,1,757,3360,550,824,233,1,1608,133,363,218,1,715
Bulloch,11,64.00%,46.40%,52.60%,62.50%,45.10%,51.40%,6312,386,1158,360,3,1907,420,1002,641,11,2074,6312,389,1169,361,3,1922,403,962,601,11,1977
Bulloch,12,50.90%,25.20%,17.60%,53.00%,24.90%,17.70%,1735,439,285,115,0,839,94,96,119,0,309,1735,433,286,103,0,822,93,95,116,0,304
Bulloch,13,55.00%,35.40%,35.90%,52.40%,35.10%,36.70%,6335,479,1634,442,4,2559,264,895,540,6,1705,6335,474,1622,451,5,2552,273,878,496,5,1652
Bulloch,14,66.80%,47.30%,49.60%,64.00%,45.80%,50.40%,5793,383,999,354,1,1737,371,898,712,7,1988,5793,372,1018,369,0,1759,371,861,657,7,1896
Bulloch,15,67.20%,64.30%,59.30%,66.50%,63.20%,60.10%,5279,303,517,172,0,992,438,930,353,4,1725,5279,294,524,164,0,982,439,900,326,4,1669
Bulloch,16,33.00%,16.30%,10.00%,35.80%,16.80%,9.40%,1000,361,201,67,1,630,39,39,33,1,112,1000,355,198,61,1,615,36,40,34,1,111
Bulloch,2,47.80%,25.80%,12.90%,45.00%,25.90%,13.50%,1947,449,511,167,2,1129,66,178,153,1,398,1947,446,508,172,2,1128,69,178,141,1,389
Bulloch,3,57.90%,32.40%,23.20%,57.50%,31.60%,23.80%,2403,447,474,154,4,1079,135,227,212,1,575,2403,438,468,145,3,1054,137,216,196,1,550
Bulloch,4,40.30%,22.60%,15.10%,40.50%,22.10%,16.50%,3351,687,945,246,2,1880,121,276,166,2,565,3351,669,942,238,2,1851,131,268,162,2,563
Bulloch,5,39.80%,16.70%,8.70%,42.30%,17.20%,8.80%,2137,622,434,136,1,1193,59,87,90,0,236,2137,614,427,124,1,1166,59,89,91,0,239
Bulloch,6,38.00%,16.80%,10.90%,39.80%,16.50%,11.00%,1610,530,346,111,0,987,65,70,68,0,203,1610,519,343,106,0,968,64,68,70,0,202
Bulloch,7,36.90%,18.80%,11.80%,32.40%,18.50%,13.10%,1299,382,259,99,0,740,50,60,58,1,169,1299,373,256,100,0,729,55,58,48,1,162
Bulloch,8,33.30%,15.40%,11.80%,31.30%,14.30%,12.40%,488,186,66,46,0,298,25,12,23,0,60,488,184,66,44,0,294,26,11,20,0,57
Bulloch,9,54.50%,34.70%,26.00%,54.70%,35.00%,24.80%,969,212,141,56,2,411,75,75,67,0,217,969,210,141,53,2,406,70,76,64,0,210
Burke,1,82.50%,25.00%,24.30%,80.50%,22.10%,22.90%,389,84,60,14,0,158,27,20,66,0,113,389,84,60,15,0,159,25,17,62,0,104
Burke,2,53.20%,30.30%,22.50%,50.00%,30.70%,21.70%,2558,452,497,137,0,1086,131,216,156,0,503,2558,451,490,139,0,1080,125,217,139,0,481
Burke,3,67.50%,41.30%,47.60%,68.00%,40.30%,45.00%,733,110,81,41,0,232,100,57,85,0,242,733,110,80,39,0,229,90,54,83,0,227
Burke,4,86.30%,39.60%,55.20%,86.10%,39.60%,58.10%,434,39,61,16,0,116,48,40,101,0,189,434,36,61,16,0,113,50,40,99,0,189
Burke,5,70.80%,30.40%,35.00%,70.10%,29.50%,35.70%,1036,152,222,38,0,412,82,97,92,0,271,1036,144,220,38,0,402,80,92,89,0,261
Burke,6,70.20%,20.80%,60.60%,70.70%,22.60%,63.30%,476,63,42,14,0,119,97,11,33,0,141,476,58,41,12,0,111,100,12,29,0,141
Burke,7,85.10%,55.60%,50.50%,82.20%,53.30%,46.90%,492,91,20,11,0,122,93,25,63,0,181,492,95,21,13,0,129,84,24,60,0,168
Burke,8,88.20%,36.80%,26.40%,93.80%,36.00%,27.10%,299,64,48,4,0,116,23,28,30,0,81,299,62,48,2,0,112,23,27,30,0,80
Burke,9,48.20%,38.30%,37.60%,44.70%,36.30%,37.80%,1049,211,124,57,0,392,127,77,53,0,257,1049,211,123,57,0,391,128,70,46,0,244
Burke,10,90.20%,73.30%,47.50%,90.20%,66.70%,46.30%,294,42,16,5,0,63,38,44,46,0,128,294,43,19,5,0,67,37,38,46,0,121
Burke,11,69.90%,42.00%,30.90%,68.10%,42.30%,31.50%,1121,152,174,52,0,378,68,126,121,0,315,1121,150,169,53,0,372,69,124,113,0,306
Burke,12,72.90%,32.20%,38.20%,72.60%,32.50%,37.40%,442,68,82,23,0,173,42,39,62,0,143,442,67,81,23,0,171,40,39,61,0,140
Burke,13,85.50%,40.50%,36.30%,84.30%,42.50%,37.40%,313,72,25,8,0,105,41,17,47,0,105,313,72,23,8,0,103,43,17,43,0,103
Burke,14,88.30%,59.90%,78.60%,86.40%,59.00%,76.10%,2949,79,336,67,0,482,290,501,505,0,1296,2949,87,338,75,0,500,277,486,476,0,1239
Burke,15,68.70%,34.00%,47.80%,65.90%,32.40%,48.00%,3290,233,896,152,0,1281,213,461,333,0,1007,3290,226,919,158,0,1303,209,440,306,0,955
Burke,16,88.10%,44.10%,65.40%,87.30%,44.30%,64.20%,681,37,118,10,0,165,70,93,74,0,237,681,38,117,10,0,165,68,93,69,0,230
Butts,BCAB,46.10%,23.00%,31.30%,44.30%,22.60%,31.10%,17154,824,6443,1137,2,8406,376,1924,973,1,3274,17154,823,6380,1124,2,8329,372,1863,893,1,3129
Calhoun,1,76.40%,44.00%,53.90%,74.50%,41.70%,52.40%,721,77,116,34,0,227,90,91,110,0,291,721,79,120,35,0,234,87,86,102,0,275
Calhoun,2,50.00%,23.00%,20.20%,48.80%,22.10%,20.60%,662,87,201,62,0,350,22,60,62,0,144,662,85,201,62,0,348,22,57,59,0,138
Calhoun,3,85.10%,77.60%,76.80%,82.20%,74.80%,75.80%,523,23,30,11,0,64,76,104,63,0,243,523,23,33,13,0,69,72,98,60,0,230
Calhoun,4,70.70%,57.00%,54.00%,70.50%,56.20%,51.20%,594,57,77,27,0,161,67,102,65,0,234,594,60,78,26,0,164,63,100,62,0,225
Calhoun,5,89.50%,60.20%,75.20%,91.30%,59.20%,75.40%,684,35,70,16,0,121,106,106,136,0,348,684,34,71,13,0,118,104,103,136,0,343
Camden,1,60.40%,21.20%,18.50%,57.80%,21.20%,18.90%,979,220,215,55,0,490,50,58,84,0,192,979,214,212,54,0,480,50,57,74,0,181
Camden,2,53.90%,18.20%,21.60%,51.50%,17.80%,22.40%,1530,276,467,143,0,886,76,104,167,0,347,1530,266,467,143,0,876,77,101,152,0,330
Camden,3,64.80%,34.40%,27.10%,63.80%,34.50%,27.10%,1973,257,479,105,1,842,96,251,193,0,540,1973,255,468,101,1,825,95,247,178,0,520
Camden,4,44.60%,10.80%,6.00%,39.80%,10.20%,8.40%,698,126,207,51,0,384,8,25,41,0,74,698,120,202,50,0,372,11,23,33,0,67
Camden,5,43.50%,20.60%,11.50%,40.00%,20.60%,11.80%,1834,361,583,131,0,1075,46,151,101,1,299,1834,353,571,129,0,1053,46,148,86,1,281
Camden,6,44.80%,23.70%,22.40%,39.80%,22.90%,24.50%,2782,295,896,164,0,1355,85,279,133,0,497,2782,278,887,160,0,1325,90,264,106,0,460
Camden,7,77.00%,46.80%,40.90%,76.10%,46.00%,41.30%,2599,188,485,74,0,747,130,426,248,0,804,2599,183,473,71,0,727,129,403,226,0,758
Camden,8,62.00%,35.00%,28.80%,61.30%,33.60%,31.70%,2274,178,495,90,0,763,72,266,147,0,485,2274,164,498,82,0,744,76,252,130,0,458
Camden,9,56.40%,31.60%,28.30%,54.10%,30.90%,26.70%,6866,486,1942,397,0,2825,192,898,514,0,1604,6866,480,1911,392,0,2783,175,854,462,0,1491
Camden,10,54.50%,38.90%,36.00%,54.80%,38.10%,40.50%,2095,158,316,81,0,555,88,201,97,1,387,2095,135,314,75,0,524,91,193,91,1,376
Camden,11,61.30%,37.80%,29.20%,61.20%,36.60%,27.60%,3218,335,714,173,0,1222,138,433,274,0,845,3218,336,707,163,0,1206,128,408,257,0,793
Camden,12,61.00%,28.10%,18.60%,58.10%,28.10%,17.70%,2139,207,646,157,3,1013,48,252,246,0,546,2139,202,637,161,3,1003,44,249,223,0,516
Camden,13,56.50%,28.40%,21.80%,53.60%,27.70%,22.20%,2816,312,822,174,0,1308,86,326,226,1,639,2816,291,808,176,0,1275,82,310,203,1,596
Camden,14,45.50%,22.70%,18.70%,41.00%,21.60%,18.40%,3147,222,1198,366,0,1786,51,351,306,0,708,3147,218,1200,376,0,1794,49,330,261,0,640
Candler,CAND,50.10%,23.10%,31.00%,49.80%,23.10%,30.20%,6300,431,2327,375,0,3133,193,699,376,1,1269,6300,435,2281,361,0,3077,187,687,358,1,1233
Carroll,1006,24.30%,7.40%,4.30%,23.90%,8.30%,4.20%,1165,441,261,84,1,787,20,21,27,0,68,1165,436,255,83,1,775,19,23,26,0,68
Carroll,1111,43.90%,23.60%,17.40%,41.50%,23.50%,17.50%,3289,621,659,202,1,1483,130,204,158,1,493,3289,604,645,203,1,1453,127,198,144,1,470
Carroll,1122,44.30%,24.40%,22.50%,45.20%,24.30%,22.60%,4459,486,1316,249,2,2053,141,425,198,1,765,4459,475,1296,233,2,2006,139,415,192,0,746
Carroll,1152,28.80%,11.20%,6.60%,25.90%,9.90%,6.50%,1775,449,602,136,1,1188,32,76,55,0,163,1775,442,608,137,1,1188,31,67,48,0,146
Carroll,1240,37.60%,14.70%,11.60%,34.90%,14.90%,10.10%,2641,625,668,159,0,1452,82,115,96,0,293,2641,626,658,157,0,1441,70,115,84,0,269
Carroll,1371,31.30%,17.00%,12.40%,29.30%,17.00%,12.80%,1564,380,381,123,2,886,54,78,56,0,188,1564,373,377,123,1,874,55,77,51,0,183
Carroll,1483,41.30%,19.20%,19.10%,41.50%,18.30%,20.10%,3695,445,1392,257,1,2095,103,331,181,2,617,3695,429,1383,250,1,2063,107,309,177,1,594
Carroll,1496,42.30%,21.30%,16.80%,38.80%,20.80%,19.20%,1547,242,402,94,0,738,49,109,69,0,227,1547,227,400,93,0,720,54,105,59,0,218
Carroll,1533,32.30%,13.60%,8.00%,31.70%,13.40%,7.40%,1920,540,496,132,0,1168,46,78,63,1,188,1920,540,496,127,0,1163,43,77,59,0,179
Carroll,1540,51.50%,24.70%,16.00%,48.80%,24.10%,16.20%,3867,835,1056,260,0,2151,159,347,276,0,782,3867,815,1048,261,0,2124,158,333,249,0,740
Carroll,1542,40.00%,15.10%,13.60%,37.90%,14.70%,13.60%,2408,481,779,141,0,1401,76,139,94,0,309,2408,475,773,141,0,1389,75,133,86,0,294
Carroll,501,62.40%,36.00%,33.60%,60.80%,36.20%,34.80%,4779,379,1026,179,1,1585,192,577,297,0,1066,4779,361,1009,179,0,1549,192,572,278,1,1043
Carroll,640,37.20%,17.80%,20.90%,36.10%,17.50%,20.90%,2942,276,997,216,1,1490,73,216,128,0,417,2942,272,988,205,1,1466,72,209,116,0,397
Carroll,641,52.40%,25.80%,23.90%,52.20%,26.20%,24.20%,5472,529,1526,303,0,2358,166,530,334,0,1030,5472,503,1487,287,0,2277,161,527,314,0,1002
Carroll,642,66.80%,46.70%,46.20%,64.50%,47.50%,48.30%,7250,410,1359,298,0,2067,351,1189,599,1,2140,7250,389,1322,297,0,2008,363,1195,539,1,2098
Carroll,649,37.40%,16.30%,14.50%,37.40%,16.40%,14.70%,4354,641,1257,254,2,2154,107,245,152,2,506,4354,625,1232,234,2,2093,106,241,140,2,489
Carroll,650,54.80%,33.30%,23.50%,54.30%,33.40%,24.10%,3700,550,810,164,3,1527,169,405,199,1,774,3700,537,799,159,1,1496,170,401,189,1,761
Carroll,682,33.70%,14.50%,6.80%,33.70%,14.20%,9.40%,2190,544,559,136,0,1239,40,95,69,0,204,2190,523,558,130,0,1211,54,92,66,0,212
Carroll,713,37.00%,12.70%,9.00%,36.00%,11.50%,8.00%,3200,635,1017,209,4,1865,63,148,123,0,334,3200,631,1023,203,4,1861,55,133,114,0,302
Carroll,714A1,72.80%,59.90%,67.50%,73.00%,59.10%,65.00%,4380,138,537,126,1,802,286,803,337,3,1429,4380,143,538,115,1,797,266,779,311,2,1358
Carroll,714A2,54.90%,40.60%,34.90%,53.60%,40.80%,36.30%,1671,98,395,96,1,590,53,270,117,0,440,1671,92,389,91,1,573,53,268,105,0,426
Carroll,714A3,58.60%,40.70%,41.40%,55.60%,39.30%,39.20%,3736,200,960,166,1,1327,141,658,235,1,1035,3736,208,974,170,1,1353,134,631,213,1,979
Carroll,714A4,62.10%,38.80%,57.90%,57.50%,35.10%,56.70%,2164,113,464,88,2,667,157,294,144,1,596,2164,118,490,94,2,704,157,265,127,0,549
Carroll,714A5,57.30%,39.90%,34.60%,54.60%,39.00%,32.30%,2620,158,685,150,1,994,83,454,201,1,739,2620,158,686,149,1,994,76,438,179,0,693
Carroll,714A6,43.60%,32.60%,40.10%,40.50%,31.40%,41.70%,1628,102,450,155,1,708,69,218,120,0,407,1628,97,459,160,1,717,70,210,109,0,389
Carroll,714BN,53.80%,30.40%,29.00%,49.10%,29.70%,28.20%,1466,124,428,85,1,638,51,187,99,0,337,1466,124,422,86,1,633,49,178,83,0,310
Carroll,714BW,46.10%,24.20%,18.30%,44.00%,22.00%,17.10%,2297,338,725,151,2,1216,76,232,129,0,437,2297,338,739,150,2,1229,70,209,118,0,397
Carroll,715,47.60%,22.70%,11.50%,48.40%,21.40%,10.50%,1668,291,469,86,1,847,38,138,78,0,254,1668,289,471,80,0,840,34,128,75,0,237
Catoosa,BLCK,34.50%,15.40%,9.60%,35.70%,15.70%,9.30%,1952,386,588,114,0,1088,40,107,60,1,208,1952,371,576,108,0,1055,37,107,60,1,205
Catoosa,BOYN,45.20%,18.70%,15.90%,41.80%,18.50%,15.80%,6027,685,2445,368,3,3501,130,562,304,0,996,6027,669,2398,372,2,3441,126,544,267,0,937
Catoosa,CAKT,39.30%,15.80%,10.00%,38.50%,16.60%,10.70%,2611,485,877,170,0,1532,54,165,110,0,329,2611,475,838,163,0,1476,57,167,102,0,326
Catoosa,CHAM,38.40%,13.90%,14.50%,37.00%,13.90%,13.90%,2552,328,1130,180,3,1641,56,183,112,0,351,2552,326,1119,177,2,1624,52,181,104,1,338
Catoosa,FT O,40.80%,22.50%,22.30%,39.80%,22.30%,23.10%,4054,378,1296,314,1,1989,109,376,216,0,701,4054,360,1261,301,0,1922,107,362,199,1,669
Catoosa,GRAY,45.70%,17.30%,15.50%,43.00%,16.80%,16.10%,4501,564,1617,255,3,2439,104,339,215,0,658,4501,549,1598,249,2,2398,106,322,188,0,616
Catoosa,LAKE,40.50%,19.10%,20.00%,40.80%,19.00%,21.00%,3572,354,1098,201,1,1654,88,259,137,1,485,3572,333,1063,187,1,1584,88,249,129,1,467
Catoosa,POPS,41.40%,16.00%,13.20%,39.80%,16.10%,14.20%,4191,474,1691,268,0,2433,71,321,189,1,582,4191,460,1661,254,0,2375,75,318,168,1,562
Catoosa,RING,44.50%,20.40%,20.20%,43.00%,19.80%,20.20%,7414,581,2980,516,3,4080,148,766,413,0,1327,7414,565,2946,495,3,4009,144,729,374,0,1247
Catoosa,WEST,38.00%,20.70%,18.20%,38.00%,20.20%,18.90%,5895,412,2126,418,2,2958,92,554,256,0,902,5895,396,2093,386,2,2877,93,530,237,0,860
Catoosa,WOOD,44.40%,14.00%,13.70%,42.60%,13.90%,13.40%,2946,523,1177,148,4,1852,84,191,118,0,393,2946,513,1151,143,3,1810,79,186,106,1,372
Charlton,2,68.40%,48.30%,57.80%,65.10%,46.40%,53.40%,2420,135,478,98,0,711,185,447,212,0,844,2420,142,478,103,0,723,163,414,192,0,769
Charlton,3B,4.30%,17.60%,2.90%,4.40%,16.70%,5.20%,509,232,56,44,0,332,7,12,2,0,21,509,220,55,43,0,318,12,11,2,0,25
Charlton,3S,18.60%,2.80%,2.90%,13.00%,4.40%,3.90%,661,232,137,48,1,418,7,4,11,0,22,661,223,130,47,1,401,9,6,7,0,22
Charlton,4A,25.90%,7.10%,5.00%,21.30%,6.60%,6.50%,748,134,341,60,0,535,7,26,21,0,54,748,129,339,59,0,527,9,24,16,0,49
Charlton,4H,19.40%,9.40%,9.90%,17.70%,9.30%,11.30%,864,155,329,54,0,538,17,34,13,0,64,864,149,322,51,0,522,19,33,11,0,63
Charlton,5F,28.40%,9.40%,2.60%,21.20%,9.10%,1.30%,767,75,358,53,0,486,2,37,21,0,60,767,76,350,52,0,478,1,35,14,0,50
Charlton,5R,25.00%,10.30%,2.70%,26.10%,11.30%,4.20%,266,70,105,18,1,194,2,12,6,0,20,266,68,102,17,0,187,3,13,6,0,22
Charlton,5W,26.70%,4.20%,6.20%,21.40%,4.30%,6.30%,317,91,92,22,0,205,6,4,8,0,18,317,90,89,22,0,201,6,4,6,0,16
Chatham,1-01C,74.60%,63.40%,39.40%,71.90%,63.10%,39.00%,3187,318,392,242,0,952,207,679,711,0,1597,3187,319,393,261,0,973,204,671,668,0,1543
Chatham,1-05C,72.10%,62.90%,43.90%,72.10%,62.30%,43.30%,2106,206,241,147,1,595,162,408,379,0,949,2106,211,241,141,0,593,161,399,365,0,925
Chatham,1-06C,60.90%,46.30%,24.80%,57.90%,45.70%,24.20%,2035,339,300,214,1,854,110,259,333,2,704,2035,340,299,225,1,865,107,252,309,2,670
Chatham,1-08C,61.40%,53.90%,31.30%,58.50%,53.20%,29.90%,1667,286,207,135,0,628,129,242,215,1,587,1667,289,206,139,0,634,122,234,196,1,553
Chatham,1-09C,73.00%,61.30%,45.50%,67.20%,61.40%,45.90%,739,81,60,37,3,181,70,95,100,0,265,739,78,59,43,2,182,67,94,88,1,250
Chatham,1-10C,47.20%,38.70%,17.90%,42.40%,36.30%,18.20%,1101,319,166,140,1,626,70,105,125,0,300,1101,322,172,148,1,643,72,98,109,0,279
Chatham,1-12C,49.60%,35.30%,19.50%,44.50%,33.60%,15.90%,1909,483,363,233,1,1080,117,198,229,0,544,1909,506,368,252,1,1127,96,186,202,0,484
Chatham,1-13C,63.10%,37.40%,27.10%,61.50%,37.30%,29.00%,1396,246,236,106,1,589,92,141,181,0,414,1396,237,237,104,1,579,97,141,166,0,404
Chatham,1-14C,54.40%,34.20%,23.50%,52.20%,35.30%,24.90%,1718,240,349,195,1,785,74,181,233,0,488,1718,240,342,196,1,779,80,187,214,0,481
Chatham,1-16C,46.20%,25.30%,19.30%,46.50%,24.30%,18.90%,2905,583,640,269,5,1497,140,217,231,1,589,2905,581,648,258,4,1491,135,208,224,1,568
Chatham,1-17C,54.10%,24.30%,21.00%,50.50%,24.30%,19.00%,3136,447,811,408,0,1666,118,260,481,1,860,3136,457,805,418,0,1680,106,258,427,1,792
Chatham,2-02C,84.50%,78.10%,83.00%,83.00%,75.70%,82.60%,1714,44,74,42,1,161,212,264,229,8,713,1714,45,82,43,1,171,212,256,210,7,685
Chatham,2-03C,93.30%,83.80%,80.90%,91.30%,83.80%,78.00%,1609,48,49,18,0,115,202,253,251,1,707,1609,55,48,23,0,126,194,249,242,1,686
Chatham,2-04C,95.40%,93.70%,87.90%,95.10%,93.40%,87.60%,3178,59,41,29,0,129,428,610,607,2,1647,3178,60,42,30,0,132,421,598,577,1,1597
Chatham,2-05C,93.20%,90.10%,83.40%,94.00%,89.60%,83.30%,2079,54,54,26,1,135,273,492,355,3,1123,2079,53,56,22,1,132,267,482,346,3,1098
Chatham,2-06C,95.20%,78.20%,81.20%,94.60%,83.50%,80.10%,759,29,31,5,0,65,122,111,99,3,335,759,30,23,5,0,58,118,116,87,3,324
Chatham,2-07C,90.00%,88.00%,78.60%,88.30%,87.70%,76.50%,2808,94,78,48,0,220,343,570,431,3,1347,2808,101,79,54,0,234,327,563,407,2,1299
Chatham,2-09C,92.20%,87.60%,79.20%,92.60%,87.90%,77.80%,3342,100,102,54,0,256,376,720,642,4,1742,3342,105,98,49,0,252,365,711,616,4,1696
Chatham,2-11C,89.50%,80.50%,81.90%,89.30%,79.70%,81.60%,1900,66,65,32,0,163,295,268,273,3,839,1900,66,67,31,0,164,290,263,260,3,816
Chatham,2-12C,95.50%,86.50%,76.90%,94.30%,86.80%,77.60%,1683,56,53,14,0,123,182,339,298,4,823,1683,53,51,17,0,121,180,334,279,4,797
Chatham,3-01C,68.70%,66.10%,32.40%,63.10%,62.70%,37.10%,458,48,38,36,0,122,22,74,79,1,176,458,44,41,41,0,126,25,69,70,1,165
Chatham,3-02C,76.20%,62.80%,38.80%,70.90%,60.60%,37.70%,1598,124,185,99,2,410,79,312,317,1,709,1598,127,193,115,2,437,78,297,280,0,655
Chatham,3-03C,86.70%,87.20%,93.50%,88.00%,86.40%,90.30%,1185,14,30,20,0,64,199,204,130,4,537,1185,20,31,17,1,69,192,197,125,3,517
Chatham,3-04C,94.60%,94.60%,89.80%,93.60%,93.00%,89.90%,1558,35,14,14,0,63,308,246,244,0,798,1558,34,18,16,0,68,301,239,235,0,775
Chatham,3-05C,81.90%,74.50%,68.40%,83.90%,75.00%,71.00%,2107,121,117,62,0,300,260,341,281,2,884,2107,108,112,52,0,272,263,336,270,2,871
Chatham,3-08C,82.20%,72.50%,60.60%,82.10%,72.00%,60.30%,1210,82,93,42,0,217,126,245,194,0,565,1210,83,93,42,0,218,126,239,192,0,557
Chatham,3-09C,62.60%,49.70%,26.30%,60.80%,48.30%,31.70%,664,166,76,52,2,296,60,75,87,0,222,664,156,77,51,1,285,72,72,79,1,224
Chatham,3-10C,91.50%,88.40%,78.00%,90.80%,87.70%,80.00%,2640,108,69,43,0,220,380,527,460,2,1369,2640,98,72,45,0,215,392,514,444,1,1351
Chatham,3-11C,85.20%,80.70%,78.90%,84.90%,79.90%,80.30%,1481,61,64,36,1,162,230,267,208,2,707,1481,56,66,35,1,158,231,263,197,2,693
Chatham,3-12C,74.00%,52.70%,41.00%,74.40%,52.70%,43.60%,1678,258,184,86,0,528,178,205,245,1,629,1678,244,181,81,0,506,189,202,236,0,627
Chatham,3-13C,66.60%,61.90%,56.30%,67.10%,60.60%,55.80%,2303,165,230,130,0,525,211,373,259,2,845,2303,164,237,122,0,523,206,364,249,1,820
Chatham,3-14C,83.10%,74.60%,74.00%,82.30%,75.00%,76.90%,2381,88,163,93,0,344,250,478,457,1,1186,2381,77,158,94,0,329,255,475,436,1,1167
Chatham,3-15C,63.10%,51.40%,53.30%,58.90%,49.80%,50.80%,816,57,125,96,0,278,65,132,164,0,361,816,60,128,104,0,292,62,127,149,0,338
Chatham,4-02C,61.40%,32.10%,24.50%,63.00%,32.80%,26.80%,2472,332,531,181,0,1044,108,251,288,0,647,2472,317,519,166,0,1002,116,253,283,0,652
Chatham,4-04C,56.70%,28.60%,17.20%,53.60%,28.20%,17.80%,2470,478,511,231,2,1222,98,205,303,2,608,2470,469,511,238,3,1221,101,201,275,1,578
Chatham,4-05C,56.10%,31.10%,22.60%,53.00%,31.70%,23.10%,2244,464,457,203,1,1125,136,206,259,0,601,2244,453,452,205,1,1111,136,210,231,0,577
Chatham,4-06C,52.60%,24.00%,19.70%,51.20%,24.60%,19.30%,2252,449,553,221,3,1226,111,175,245,0,531,2252,451,551,224,2,1228,108,180,235,0,523
Chatham,4-07C,60.60%,29.20%,20.90%,57.50%,28.20%,21.20%,3370,532,730,302,4,1568,142,301,464,0,907,3370,517,734,314,4,1569,140,288,425,0,853
Chatham,4-08C,51.20%,24.90%,17.90%,48.40%,24.00%,17.60%,2678,518,656,322,1,1497,112,218,338,1,669,2678,522,665,332,1,1520,111,210,312,1,634
Chatham,4-10C,60.80%,40.80%,29.20%,54.70%,39.00%,28.60%,1469,343,212,118,1,674,141,146,183,1,471,1469,346,216,131,1,694,138,138,158,1,435
Chatham,4-11C,60.80%,40.10%,28.10%,60.80%,40.50%,27.10%,1640,481,169,121,1,772,187,113,188,1,489,1640,487,166,118,1,772,181,113,183,0,477
Chatham,4-12C,48.80%,26.80%,17.50%,45.50%,24.50%,14.70%,2294,549,446,355,3,1353,117,163,338,0,618,2294,572,459,365,3,1399,99,149,305,0,553
Chatham,4-13C,49.30%,32.30%,16.50%,42.80%,29.90%,13.30%,2469,470,469,434,2,1375,92,224,422,1,739,2469,499,485,482,2,1468,76,207,360,1,644
Chatham,4-14C,55.70%,31.90%,14.60%,50.80%,29.80%,11.40%,1744,360,311,275,2,948,61,146,346,1,554,1744,371,321,297,3,992,48,136,307,0,491
Chatham,4-15C,48.60%,32.40%,16.30%,42.80%,30.20%,14.40%,0,289,313,386,4,992,57,150,365,0,572,0,298,321,421,4,1044,51,139,315,0,505
Chatham,5-01C,78.70%,78.80%,66.50%,78.80%,77.70%,67.30%,1063,69,49,37,0,155,137,182,137,0,456,1063,67,50,34,0,151,138,174,126,0,438
Chatham,5-02C,92.10%,90.50%,79.40%,94.50%,91.50%,79.60%,783,27,12,11,1,51,108,114,128,0,350,783,27,11,7,1,46,109,118,120,0,347
Chatham,5-03C,97.40%,96.00%,95.20%,97.80%,95.30%,95.40%,1078,10,7,5,0,22,191,166,187,6,550,1078,9,8,4,0,21,182,164,176,6,528
Chatham,5-05C,97.50%,97.50%,94.70%,97.40%,96.90%,93.70%,2574,24,15,15,0,54,426,575,590,2,1593,2574,28,18,15,0,61,417,570,563,1,1551
Chatham,5-06C,88.90%,86.20%,76.20%,89.70%,86.80%,76.40%,2598,82,70,43,2,197,262,439,346,7,1054,2598,80,66,37,1,184,255,435,322,7,1019
Chatham,5-07C,78.70%,77.80%,68.50%,80.10%,79.40%,67.80%,1856,102,95,64,0,261,218,333,236,4,791,1856,101,86,56,0,243,208,331,225,5,769
Chatham,5-08C,80.50%,71.40%,65.50%,81.00%,71.80%,67.20%,1848,100,132,72,0,304,187,329,298,3,817,1848,94,126,65,0,285,190,321,278,3,792
Chatham,5-10C,96.70%,94.30%,93.50%,96.50%,93.60%,93.60%,3507,38,41,23,0,102,543,679,683,5,1910,3507,37,45,24,0,106,535,661,658,5,1859
Chatham,5-11C,70.50%,80.80%,79.20%,69.50%,80.70%,80.80%,3019,83,144,169,2,398,316,605,404,7,1332,3019,74,142,165,2,383,314,593,376,6,1289
Chatham,6-01C,72.10%,69.50%,52.00%,72.00%,69.30%,54.70%,1919,157,148,94,3,402,171,338,243,2,754,1919,145,149,87,3,384,177,336,224,2,739
Chatham,6-02C,61.40%,42.30%,28.00%,58.90%,42.30%,27.30%,2290,391,400,205,0,996,151,293,326,1,771,2290,394,395,217,0,1006,147,289,311,1,748
Chatham,6-03C,74.20%,58.20%,46.20%,71.10%,58.00%,45.10%,2736,270,340,161,1,772,231,474,463,2,1170,2736,276,341,176,1,794,227,471,432,1,1131
Chatham,6-05C,69.80%,64.20%,59.20%,70.90%,64.50%,59.90%,1993,145,179,112,0,436,210,321,259,0,790,1993,144,177,102,0,423,215,321,249,0,785
Chatham,6-06C,62.00%,46.70%,49.80%,61.50%,47.20%,50.80%,1543,140,209,93,0,442,139,183,152,0,474,1543,130,205,89,0,424,134,183,142,0,459
Chatham,6-08C,77.20%,73.10%,68.90%,78.40%,72.60%,69.40%,2194,103,147,84,0,334,226,400,284,2,912,2194,98,147,72,0,317,220,389,262,2,873
Chatham,6-09C,64.10%,56.40%,47.40%,64.60%,56.80%,48.50%,3319,308,428,240,1,977,272,553,429,7,1261,3319,299,417,228,1,945,276,548,416,6,1246
Chatham,6-10C,68.20%,49.00%,40.70%,67.60%,49.10%,40.90%,4184,387,682,296,2,1367,264,655,635,3,1557,4184,387,677,291,1,1356,263,653,608,5,1529
Chatham,6-11C,78.50%,68.00%,55.60%,79.00%,68.70%,57.50%,5149,343,465,182,4,994,429,990,666,6,2091,5149,325,451,171,4,951,440,990,645,6,2081
Chatham,7-01C,56.90%,42.70%,38.20%,58.10%,43.70%,38.00%,1542,194,193,109,0,496,120,144,144,0,408,1542,186,184,104,0,474,114,143,144,0,401
Chatham,7-03C,52.20%,32.30%,24.60%,53.20%,31.90%,24.20%,1290,304,130,76,0,510,99,62,83,0,244,1290,298,130,72,0,500,95,61,82,0,238
Chatham,7-04C,85.80%,79.50%,66.40%,86.60%,79.50%,68.30%,3067,197,185,59,0,441,388,719,356,1,1464,3067,184,182,54,0,420,395,705,348,1,1449
Chatham,7-05C,75.50%,57.30%,49.80%,73.80%,59.10%,52.20%,1305,140,134,37,0,311,139,180,114,0,433,1305,131,128,38,0,297,143,185,107,0,435
Chatham,7-06C,68.40%,45.60%,43.60%,68.90%,46.00%,44.10%,3555,241,607,181,1,1030,186,508,392,1,1087,3555,237,595,171,1,1004,187,506,379,1,1073
Chatham,7-07C,53.80%,33.30%,33.00%,52.30%,33.00%,33.00%,3932,275,930,373,3,1581,133,464,435,4,1036,3932,271,922,369,1,1563,131,454,404,3,992
Chatham,7-08C,40.10%,17.10%,14.40%,41.70%,16.80%,15.60%,2733,519,651,217,0,1387,86,134,145,1,366,2733,504,642,196,0,1342,92,130,140,1,363
Chatham,7-09C,72.40%,53.90%,48.00%,71.00%,54.50%,48.00%,2823,236,319,147,3,705,219,373,385,2,979,2823,234,314,149,3,700,218,376,365,1,960
Chatham,7-10C,76.20%,63.40%,54.30%,76.30%,64.50%,55.70%,4288,280,450,168,2,900,329,780,537,6,1652,4288,271,430,159,1,861,336,781,511,6,1634
Chatham,7-11C,77.20%,62.20%,48.90%,77.70%,62.40%,51.00%,6469,472,740,246,6,1464,451,1219,831,7,2508,6469,444,729,228,3,1404,459,1210,795,6,2470
Chatham,7-12C,71.10%,55.90%,49.00%,70.60%,56.00%,48.90%,3334,180,548,202,3,933,176,696,497,0,1369,3334,178,546,197,4,925,174,694,472,0,1340
Chatham,7-13C,53.70%,28.90%,24.70%,53.50%,28.20%,23.40%,2513,225,705,358,1,1289,74,286,415,0,775,2513,228,709,350,1,1288,70,278,402,0,750
Chatham,7-14C,73.20%,66.60%,59.70%,72.20%,66.70%,58.70%,7572,398,777,453,1,1629,584,1547,1236,7,3374,7572,399,764,449,3,1615,567,1529,1168,5,3269
Chatham,7-15C,79.20%,67.70%,49.80%,79.00%,68.20%,51.10%,2564,261,211,71,3,546,260,442,270,2,974,2564,253,204,69,3,529,266,437,260,2,965
Chatham,7-16C,56.70%,42.30%,35.70%,56.20%,41.60%,34.80%,3701,231,818,381,7,1437,126,600,499,6,1231,3701,225,819,365,7,1416,118,584,468,6,1176
Chatham,8-01C,84.60%,80.70%,76.10%,83.90%,79.40%,74.20%,850,22,26,16,0,64,66,109,88,4,267,850,23,28,15,0,66,63,108,78,3,252
Chatham,8-02C,88.10%,84.70%,74.00%,86.20%,85.30%,73.60%,1709,71,66,35,0,172,201,365,260,1,827,1709,69,63,39,0,171,192,365,243,0,800
Chatham,8-03C,61.40%,31.80%,25.00%,60.40%,31.80%,25.50%,831,162,103,39,0,304,54,48,62,0,164,831,158,101,38,0,297,54,47,58,0,159
Chatham,8-05C,96.50%,97.30%,91.50%,97.50%,96.80%,90.40%,1543,24,6,6,0,36,258,215,165,1,639,1543,27,7,4,0,38,253,210,156,1,620
Chatham,8-06C,98.20%,96.80%,91.50%,98.70%,97.40%,91.30%,1055,17,5,3,1,26,193,153,161,2,509,1055,17,4,2,1,24,186,149,153,2,490
Chatham,8-07C,96.80%,94.50%,94.00%,97.70%,95.40%,94.00%,630,8,6,3,0,17,125,104,90,1,320,630,8,5,2,0,15,124,104,86,1,315
Chatham,8-08C,96.50%,96.00%,95.60%,97.10%,97.00%,96.10%,1704,15,11,10,0,36,319,266,278,4,867,1704,12,8,8,1,29,314,263,266,3,846
Chatham,8-09C,96.70%,97.50%,96.10%,97.50%,97.50%,96.40%,1362,11,5,7,0,23,261,199,204,8,672,1362,10,5,5,0,20,260,194,196,8,658
Chatham,8-10C,100.00%,98.60%,97.30%,99.10%,97.80%,96.10%,1784,10,4,0,0,14,354,275,360,0,989,1784,14,6,3,0,23,346,270,341,0,957
Chatham,8-11C,98.90%,98.80%,96.60%,97.70%,97.80%,95.80%,1386,9,4,4,0,17,256,317,365,0,938,1386,11,7,8,0,26,254,314,346,0,914
Chatham,8-12C,90.10%,79.70%,78.70%,91.20%,79.10%,79.60%,1310,42,54,17,1,114,158,212,155,1,526,1310,41,56,15,0,112,158,212,156,2,528
Chatham,8-13C,49.50%,28.50%,29.00%,52.10%,27.70%,28.30%,1022,109,103,55,1,268,44,41,54,1,140,1022,108,99,46,1,254,42,38,50,1,131
Chatham,8-15C,92.70%,90.40%,88.30%,92.40%,91.20%,89.10%,1622,27,31,19,1,78,210,293,240,2,745,1622,26,28,19,0,73,210,290,232,3,735
Chatham,8-16C,67.60%,47.50%,43.40%,68.20%,48.50%,43.80%,3087,197,571,231,1,1000,150,516,483,2,1151,3087,195,555,217,1,968,152,523,465,1,1141
Chattahoochee,1,55.70%,43.50%,34.00%,55.10%,42.80%,35.00%,0,291,455,132,2,880,150,350,166,1,667,0,279,445,124,2,850,149,333,152,2,636
Chattooga,1083,62.50%,24.80%,22.50%,65.80%,27.00%,30.60%,248,31,85,15,0,131,9,28,25,0,62,248,25,81,13,0,119,11,30,25,0,66
Chattooga,1216,46.20%,12.90%,8.20%,38.50%,13.40%,10.40%,186,45,61,7,0,113,4,9,6,0,19,186,43,58,8,0,109,5,9,5,0,19
Chattooga,1382,62.50%,4.20%,10.80%,57.10%,4.20%,13.40%,169,74,23,3,0,100,8,1,5,1,15,169,71,23,3,0,97,10,1,4,1,16
Chattooga,1484,37.60%,13.60%,13.50%,33.30%,13.50%,15.30%,934,215,267,53,2,537,34,42,32,0,108,934,210,257,52,1,520,38,40,26,0,104
Chattooga,870,34.50%,12.20%,10.90%,35.50%,13.60%,12.30%,3496,581,1171,254,1,2007,71,163,134,0,368,3496,557,1129,242,1,1929,78,178,133,0,389
Chattooga,925,40.10%,19.80%,21.40%,40.60%,20.40%,21.60%,5155,548,1671,422,2,2643,149,412,283,1,845,5155,536,1625,398,1,2560,147,417,272,1,837
Chattooga,927,25.80%,6.50%,5.30%,29.40%,7.70%,6.50%,593,89,257,66,0,412,5,18,23,0,46,593,87,252,60,0,399,6,21,25,0,52
Chattooga,940,37.80%,13.40%,9.80%,37.40%,14.30%,11.70%,897,259,265,74,0,598,28,41,45,0,114,897,249,257,72,0,578,33,43,43,0,119
Chattooga,961,14.30%,10.40%,5.70%,14.30%,12.80%,9.10%,138,33,43,18,0,94,2,5,3,0,10,138,30,41,18,0,89,3,6,3,0,12
Chattooga,962,26.90%,8.10%,4.40%,27.40%,8.20%,5.60%,489,174,124,49,1,348,8,11,18,0,37,489,167,123,45,1,336,10,11,17,0,38
Chattooga,968,32.00%,17.50%,10.20%,32.70%,18.80%,10.80%,872,264,217,70,0,551,30,46,33,0,109,872,256,208,66,0,530,31,48,32,0,111
Chattooga,C-968,45.00%,26.00%,5.60%,43.30%,26.40%,8.90%,378,84,108,33,0,225,5,38,27,0,70,378,82,103,34,0,219,8,37,26,0,71
Chattooga,P-870,28.30%,10.30%,16.30%,33.30%,11.10%,14.50%,588,67,200,38,0,305,13,23,15,0,51,588,65,193,34,0,292,11,24,17,0,52
Cherokee,1,56.20%,32.90%,23.80%,53.00%,31.50%,24.50%,3050,417,745,348,2,1512,131,366,446,0,943,3050,414,752,355,2,1523,135,346,400,0,881
Cherokee,2,45.30%,23.40%,18.20%,42.70%,22.30%,17.60%,4884,754,1455,587,0,2796,168,444,487,0,1099,4884,750,1467,595,0,2812,160,420,443,0,1023
Cherokee,3,34.70%,15.20%,15.10%,32.10%,13.80%,14.20%,3592,437,1386,478,1,2302,78,248,254,0,580,3592,429,1391,484,1,2305,71,223,229,0,523
Cherokee,4,35.80%,12.20%,12.50%,35.90%,11.70%,12.50%,4065,503,1729,316,1,2549,72,241,176,0,489,4065,495,1703,297,1,2496,71,226,166,0,463
Cherokee,5,48.20%,27.50%,21.20%,47.50%,27.40%,21.60%,4115,575,1174,409,0,2158,155,445,381,0,981,4115,563,1163,397,0,2123,155,439,359,0,953
Cherokee,6,57.40%,43.00%,31.00%,55.60%,42.40%,31.40%,5906,604,1158,499,1,2262,272,872,672,0,1816,5906,591,1152,499,1,2243,271,849,626,0,1746
Cherokee,7,49.60%,26.90%,24.40%,46.30%,25.00%,23.30%,3899,387,1221,441,0,2049,125,450,434,0,1009,3899,396,1243,459,0,2098,120,414,395,0,929
Cherokee,8,40.90%,21.30%,19.90%,36.60%,20.20%,19.80%,4491,455,1636,583,0,2674,113,442,403,0,958,4491,449,1645,604,0,2698,111,416,349,0,876
Cherokee,9,46.90%,21.50%,17.20%,44.30%,20.30%,17.00%,5113,605,1828,563,0,2996,126,500,497,0,1123,5113,597,1835,563,0,2995,122,468,447,0,1037
Cherokee,10,46.70%,26.10%,27.40%,43.90%,25.40%,28.20%,8213,617,2176,1021,0,3814,233,768,893,0,1894,8213,597,2151,1028,0,3776,235,732,803,0,1770
Cherokee,11,56.20%,38.80%,36.70%,55.00%,37.50%,35.60%,4581,496,841,385,1,1723,287,534,494,1,1316,4581,491,849,372,0,1712,270,510,455,2,1237
Cherokee,13,40.90%,16.60%,14.30%,39.20%,16.40%,13.70%,4906,713,1657,493,1,2864,119,330,341,0,790,4906,706,1637,488,1,2832,112,322,314,0,748
Cherokee,14,29.10%,7.20%,5.90%,28.60%,6.30%,6.40%,895,271,284,61,0,616,17,22,25,0,64,895,263,285,60,0,608,18,19,24,0,61
Cherokee,15,53.80%,36.90%,20.10%,50.50%,34.80%,19.50%,3035,572,644,271,1,1488,144,377,315,0,836,3035,572,659,278,1,1510,139,352,284,0,775
Cherokee,16,56.20%,35.10%,34.60%,54.10%,34.60%,34.70%,5733,532,1294,487,0,2313,282,700,625,0,1607,5733,512,1285,485,0,2282,272,679,571,0,1522
Cherokee,18,39.90%,16.30%,12.80%,35.60%,15.00%,11.50%,5790,685,2170,741,0,3596,101,423,492,0,1016,5790,697,2188,761,0,3646,91,386,420,0,897
Cherokee,19,48.50%,26.50%,21.20%,45.20%,25.50%,19.20%,7334,740,2518,752,2,4012,200,906,707,0,1813,7334,754,2514,770,1,4039,178,862,635,1,1676
Cherokee,20,30.60%,12.60%,10.20%,30.60%,11.90%,9.90%,3483,486,1413,409,0,2308,55,203,180,0,438,3483,473,1408,395,0,2276,52,191,174,0,417
Cherokee,21,45.10%,24.00%,20.20%,43.10%,22.60%,20.20%,3155,371,1055,373,0,1799,94,334,307,0,735,3155,364,1066,373,0,1803,92,311,282,0,685
Cherokee,22,41.10%,24.50%,19.70%,40.50%,24.20%,20.80%,3262,446,861,271,1,1579,110,280,189,0,579,3262,433,847,261,1,1542,114,271,178,0,563
Cherokee,23,49.20%,30.00%,29.80%,48.00%,29.60%,30.00%,5482,682,1231,465,2,2380,290,527,451,0,1268,5482,669,1211,450,2,2332,288,509,416,0,1213
Cherokee,24,50.10%,28.70%,28.70%,47.40%,27.50%,27.30%,8350,752,2388,730,0,3870,302,962,732,0,1996,8350,746,2407,729,0,3882,280,912,658,0,1850
Cherokee,26,51.20%,32.60%,30.00%,47.00%,31.50%,28.10%,7480,638,1868,1077,1,3584,274,905,1131,0,2310,7480,636,1889,1129,1,3655,249,869,1002,0,2120
Cherokee,27,40.70%,17.30%,16.50%,37.40%,16.30%,16.00%,4853,611,1852,553,0,3016,121,388,380,0,889,4853,608,1854,565,0,3027,116,360,337,0,813
Cherokee,28,43.20%,23.70%,18.80%,40.60%,22.50%,19.30%,3078,526,894,334,1,1755,122,277,254,0,653,3078,513,887,330,1,1731,123,257,226,0,606
Cherokee,44,55.30%,34.20%,30.00%,52.80%,33.40%,29.50%,7642,721,1832,741,1,3295,310,954,915,0,2179,7642,708,1828,753,1,3290,296,917,842,0,2055
Cherokee,29,45.00%,25.30%,21.20%,44.40%,25.30%,22.50%,3749,561,905,381,0,1847,151,307,312,0,770,3749,542,893,369,0,1804,157,302,295,0,754
Cherokee,30,26.60%,9.20%,10.20%,25.10%,8.80%,9.40%,3468,661,1200,376,0,2237,75,121,136,0,332,3468,654,1188,371,0,2213,68,115,124,0,307
Cherokee,31,49.30%,27.20%,34.40%,47.40%,26.90%,33.30%,2525,180,666,174,1,1021,95,249,169,0,513,2525,181,661,175,1,1018,91,243,158,0,492
Cherokee,32,50.40%,26.40%,23.60%,46.60%,25.70%,22.50%,3748,478,1130,363,0,1971,148,405,369,0,922,3748,473,1134,373,0,1980,137,392,326,0,855
Cherokee,33,34.10%,11.70%,7.50%,31.30%,11.30%,8.30%,727,273,121,60,0,454,22,16,31,0,69,727,264,118,57,0,439,24,15,26,0,65
Cherokee,34,45.00%,24.10%,15.90%,41.40%,21.40%,15.40%,3101,417,982,388,0,1787,79,312,317,0,708,3101,418,1004,398,0,1820,76,274,281,0,631
Cherokee,35,28.20%,14.00%,12.90%,27.30%,14.40%,13.10%,2540,693,753,250,0,1696,102,123,98,1,324,2540,678,741,245,0,1664,101,125,92,1,319
Cherokee,36,45.80%,23.40%,21.20%,43.70%,22.80%,21.30%,7981,1061,2567,698,0,4326,285,786,591,1,1663,7981,1042,2542,689,0,4273,281,751,534,1,1567
Cherokee,37,47.40%,27.60%,23.80%,44.20%,26.30%,23.30%,6641,673,2109,647,0,3429,210,805,584,0,1599,6641,661,2117,655,0,3433,201,757,519,0,1477
Cherokee,38,38.20%,16.90%,13.50%,35.80%,16.10%,11.30%,4207,789,1416,487,1,2693,122,288,301,1,712,4207,795,1418,491,2,2706,102,273,274,0,649
Cherokee,39,35.00%,17.80%,16.00%,33.40%,17.20%,15.50%,5434,565,2010,592,0,3167,108,436,319,0,863,5434,549,2011,581,0,3141,101,418,292,0,811
Cherokee,40,41.00%,25.00%,17.90%,38.20%,24.10%,17.40%,3132,540,854,283,0,1677,118,284,197,0,599,3132,533,846,278,0,1657,112,269,172,0,553
Cherokee,41,42.00%,18.60%,11.70%,38.00%,17.60%,11.80%,2875,559,772,378,0,1709,74,176,274,0,524,2875,552,761,392,0,1705,74,162,240,0,476
Cherokee,42,45.00%,22.60%,19.00%,43.10%,21.70%,19.00%,3215,503,1009,244,0,1756,118,295,200,0,613,3215,489,1000,235,0,1724,115,277,178,0,570
Cherokee,43,58.90%,36.40%,32.00%,54.30%,36.20%,31.10%,3456,595,668,290,0,1553,280,382,416,0,1078,3456,594,657,310,0,1561,268,372,368,0,1008
Cherokee,12,54.50%,38.10%,33.70%,49.60%,36.40%,33.00%,7345,614,1699,640,1,2954,310,1046,766,2,2124,7345,604,1722,683,1,3010,296,984,673,2,1955
Clarke,1A,71.60%,66.50%,47.90%,69.90%,66.20%,47.60%,3017,294,237,183,0,714,267,470,462,3,1202,3017,285,236,187,1,709,258,462,434,2,1156
Clarke,1B,75.00%,64.30%,57.40%,72.70%,63.90%,56.50%,3645,146,408,252,1,807,197,735,756,1,1689,3645,145,407,267,3,822,191,719,710,1,1621
Clarke,1C,79.90%,66.80%,47.10%,78.10%,64.90%,45.80%,2242,155,259,147,0,561,138,521,585,0,1244,2242,160,279,156,0,595,135,516,556,0,1207
Clarke,1D,73.30%,61.90%,44.10%,71.10%,60.00%,40.90%,2830,183,357,270,1,811,144,579,740,1,1464,2830,194,372,283,0,849,134,557,695,0,1386
Clarke,2A,83.70%,80.90%,74.50%,82.00%,80.70%,74.50%,4341,154,175,131,0,460,450,741,673,0,1864,4341,150,175,140,0,465,438,731,636,0,1805
Clarke,2B,93.10%,88.20%,78.50%,91.10%,87.50%,78.60%,5136,117,154,56,0,327,420,1151,756,7,2334,5136,115,160,69,0,344,415,1117,705,7,2244
Clarke,3A,92.50%,85.80%,85.80%,90.80%,85.20%,84.30%,2938,43,97,37,1,178,262,588,455,4,1309,2938,46,100,43,2,191,255,576,425,3,1259
Clarke,3B,89.20%,81.40%,66.60%,87.10%,79.20%,65.30%,4122,128,229,71,2,430,257,999,584,2,1842,4122,131,253,81,0,465,243,966,546,4,1759
Clarke,4A,83.80%,71.80%,70.00%,81.10%,70.40%,68.30%,2072,76,178,65,0,319,176,454,336,1,967,2072,76,187,75,0,338,163,444,321,1,929
Clarke,4B,84.40%,71.90%,56.60%,81.20%,68.70%,54.90%,4096,203,407,123,2,735,266,1042,663,1,1972,4096,211,453,145,1,810,257,993,626,1,1877
Clarke,5A,76.30%,69.50%,64.90%,73.70%,68.90%,63.20%,3007,101,371,192,1,665,189,847,618,0,1654,3007,102,377,206,1,686,177,834,576,0,1587
Clarke,5B,76.70%,71.30%,63.20%,75.50%,69.60%,62.80%,3030,139,265,195,1,600,240,657,641,0,1538,3030,136,275,197,1,609,231,629,606,0,1466
Clarke,5C,93.00%,91.60%,73.70%,90.80%,90.30%,70.30%,2053,47,73,37,0,157,131,795,495,1,1422,2053,55,84,48,0,187,129,785,471,1,1386
Clarke,5D,80.60%,74.90%,75.70%,77.50%,73.70%,74.30%,3087,100,217,112,1,430,311,647,465,4,1427,3087,105,224,127,1,457,303,627,437,3,1370
Clarke,6A,63.70%,49.40%,48.30%,62.70%,49.30%,48.70%,3780,211,640,358,2,1211,196,625,629,3,1453,3780,203,633,352,0,1188,189,615,591,4,1399
Clarke,6B,72.50%,62.20%,57.00%,71.30%,60.90%,55.50%,3865,173,446,302,0,921,228,735,796,1,1760,3865,179,457,304,0,940,222,711,757,1,1691
Clarke,6C,71.00%,56.90%,47.10%,67.40%,55.30%,43.60%,3129,191,438,253,0,882,170,578,619,0,1367,3129,202,451,277,0,930,156,558,572,0,1286
Clarke,6D,85.10%,75.30%,58.20%,83.60%,74.90%,56.60%,1701,92,150,69,0,311,128,457,394,0,979,1701,96,151,74,0,321,125,450,376,0,951
Clarke,7A,70.40%,61.50%,54.10%,68.00%,59.50%,52.20%,2968,160,375,246,1,782,189,599,585,1,1374,2968,165,390,261,1,817,180,574,555,1,1310
Clarke,7B,73.10%,59.20%,57.10%,69.50%,57.50%,52.40%,3166,118,428,227,0,773,155,622,618,2,1397,3166,131,445,247,0,823,144,602,564,0,1310
Clarke,7C,75.90%,65.70%,50.90%,70.00%,61.50%,46.90%,2733,165,324,175,1,665,171,621,551,1,1344,2733,172,369,216,1,758,152,590,505,1,1248
Clarke,8A,76.50%,71.50%,60.70%,73.90%,69.90%,58.80%,3319,128,259,214,0,601,195,650,695,3,1543,3319,132,270,233,0,635,186,628,660,2,1476
Clarke,8B,76.50%,72.60%,59.90%,74.00%,71.30%,60.80%,2317,116,167,148,0,431,173,442,483,0,1098,2317,112,173,163,0,448,174,430,463,0,1067
Clarke,8C,79.80%,71.50%,61.60%,78.50%,70.40%,61.60%,3910,169,320,185,1,675,270,802,730,3,1805,3910,166,332,192,1,691,266,791,700,2,1759
Clay,1,53.10%,30.60%,23.20%,47.60%,28.60%,25.00%,383,43,100,30,0,173,13,44,34,0,91,383,42,100,33,0,175,14,40,30,0,84
Clay,2,83.80%,58.00%,71.70%,82.00%,60.20%,72.70%,366,15,55,11,0,81,38,76,57,0,171,366,15,51,11,0,77,40,77,50,0,167
Clay,3,86.80%,71.70%,84.40%,81.30%,70.00%,82.50%,390,10,34,9,0,53,54,86,59,0,199,390,11,36,12,0,59,52,84,52,0,188
Clay,4,81.80%,42.30%,57.40%,78.50%,38.50%,60.30%,453,26,86,18,0,130,35,63,81,0,179,453,23,91,20,0,134,35,57,73,0,165
Clay,5,63.70%,32.30%,40.30%,62.20%,31.20%,40.30%,461,37,126,37,0,200,25,60,65,0,150,461,37,128,37,0,202,25,58,61,0,144
Clayton,EW1,95.10%,94.90%,90.20%,94.80%,95.00%,91.70%,3020,24,62,34,0,120,217,1161,655,5,2038,3020,20,61,34,0,115,215,1154,620,5,1994
Clayton,EW2,92.40%,94.00%,86.70%,92.60%,93.70%,87.90%,3273,34,84,49,1,168,227,1307,599,2,2135,3273,32,86,46,0,164,229,1279,572,4,2084
Clayton,FP1,80.70%,77.30%,81.80%,80.90%,77.90%,84.40%,3566,85,144,84,1,314,375,489,352,11,1227,3566,73,136,78,0,287,383,478,330,11,1202
Clayton,FP2,79.90%,85.50%,76.70%,79.90%,85.90%,78.40%,2821,87,93,89,2,271,282,548,354,11,1195,2821,80,89,84,2,255,287,544,334,10,1175
Clayton,FP3,85.10%,77.50%,76.30%,85.20%,78.40%,78.00%,2845,79,132,62,2,275,241,455,353,20,1069,2845,71,124,57,2,254,240,449,327,19,1035
Clayton,FP4,67.50%,65.00%,64.10%,68.20%,65.30%,67.80%,1783,83,184,78,2,347,152,341,162,0,655,1783,74,179,71,2,326,160,337,152,0,649
Clayton,FP5,78.90%,79.00%,81.90%,78.10%,80.30%,83.50%,3924,91,191,101,0,383,393,717,377,20,1507,3924,81,175,100,0,356,391,713,357,20,1481
Clayton,FP6,61.70%,62.40%,66.90%,60.10%,62.20%,71.10%,1463,52,175,75,1,303,103,291,121,4,519,1463,45,174,73,1,293,109,286,110,4,509
Clayton,JB01,91.20%,92.70%,87.30%,91.60%,93.60%,89.30%,3244,39,73,57,0,169,263,933,592,5,1793,3244,33,64,52,0,149,268,931,570,6,1775
Clayton,JB02,94.50%,95.00%,89.30%,93.40%,94.20%,90.20%,4345,42,67,43,3,155,364,1276,735,10,2385,4345,38,77,49,3,167,367,1255,699,10,2331
Clayton,JB03,84.90%,82.80%,75.70%,85.80%,83.30%,77.10%,4107,85,238,135,2,460,264,1146,761,7,2178,4107,81,230,120,1,432,269,1145,724,7,2145
Clayton,JB04,79.30%,84.10%,82.30%,79.70%,83.40%,80.00%,2574,47,94,67,0,208,212,499,257,6,974,2574,51,97,62,0,210,199,486,244,5,934
Clayton,JB05,79.40%,77.80%,72.10%,80.70%,77.90%,75.90%,2064,83,146,77,0,306,214,511,297,1,1023,2064,71,143,68,0,282,222,503,284,1,1010
Clayton,JB06,65.90%,50.20%,47.00%,64.40%,49.80%,46.50%,2574,121,498,254,1,874,105,503,490,3,1101,2574,120,504,257,1,882,103,499,465,2,1069
Clayton,JB07,79.40%,80.90%,84.50%,78.30%,80.80%,85.50%,3174,50,206,123,0,379,266,871,475,6,1618,3174,46,205,125,0,376,266,863,452,5,1586
Clayton,JB08,91.60%,91.10%,89.50%,93.10%,91.50%,89.40%,3947,48,96,34,0,178,405,981,371,4,1761,3947,48,90,26,0,164,399,970,351,4,1724
Clayton,JB09,75.80%,87.90%,70.90%,80.20%,87.30%,76.50%,1759,55,43,56,0,154,128,313,175,6,622,1759,43,43,44,0,130,134,296,178,6,614
Clayton,JB10,86.20%,88.50%,84.90%,87.20%,89.50%,87.20%,3398,57,88,63,1,209,321,676,395,5,1397,3398,48,79,56,1,184,329,676,381,5,1391
Clayton,JB11,82.30%,80.20%,71.30%,81.90%,80.10%,75.60%,3863,96,275,151,2,524,240,1113,702,4,2059,3863,80,272,149,2,503,250,1094,674,4,2022
Clayton,JB12,91.70%,92.80%,89.10%,92.10%,93.70%,92.00%,3067,38,65,39,0,142,294,833,431,17,1575,3067,28,56,35,0,119,303,827,406,17,1553
Clayton,JB13,89.50%,87.40%,72.50%,90.40%,88.10%,73.90%,2140,80,94,42,0,216,207,651,357,4,1219,2140,74,88,37,0,199,206,651,347,4,1208
Clayton,JB14,71.80%,73.50%,67.10%,70.80%,73.30%,69.20%,4116,116,424,287,2,829,238,1179,729,3,2149,4116,107,423,287,1,818,240,1163,696,3,2102
Clayton,JB15,84.50%,89.70%,91.40%,83.70%,90.50%,91.90%,2872,23,75,45,1,144,248,652,246,8,1154,2872,22,67,45,0,134,240,637,231,8,1116
Clayton,JB16,82.70%,88.10%,81.40%,83.70%,88.10%,85.20%,2560,63,72,68,0,203,271,533,324,5,1133,2560,49,71,60,0,180,278,527,307,5,1117
Clayton,JB17,92.60%,92.30%,86.50%,92.10%,92.30%,89.50%,3359,46,65,39,0,150,283,776,490,11,1560,3359,35,63,40,0,138,287,758,465,10,1520
Clayton,JB18,84.80%,87.20%,86.70%,85.80%,86.70%,89.60%,3301,50,129,74,0,253,320,882,413,6,1621,3301,38,133,66,0,237,321,865,398,6,1590
Clayton,JB19,91.90%,90.60%,86.30%,90.90%,91.00%,90.50%,3299,45,91,45,0,181,273,880,514,11,1678,3299,31,87,48,0,166,285,876,482,12,1655
Clayton,LC1,87.00%,84.50%,85.60%,87.40%,85.50%,88.10%,3217,43,146,57,2,248,261,795,380,7,1443,3217,35,133,50,1,219,257,785,347,9,1398
Clayton,LJ1,88.20%,87.40%,79.50%,87.90%,87.60%,82.20%,4061,77,192,83,0,352,296,1331,620,2,2249,4061,66,187,81,0,334,302,1319,591,2,2214
Clayton,LJ2,87.80%,87.70%,82.20%,88.00%,88.50%,84.20%,3611,48,151,64,3,266,228,1075,461,7,1771,3611,43,138,60,1,242,226,1062,439,8,1735
Clayton,LJ3,82.10%,85.80%,84.70%,80.90%,85.10%,84.00%,1666,21,99,76,0,196,113,600,348,3,1064,1666,21,103,76,0,200,107,589,322,3,1021
Clayton,LJ4,91.00%,91.20%,86.60%,91.00%,91.10%,86.90%,4149,42,147,63,1,253,274,1518,634,3,2429,4149,41,147,60,0,248,268,1504,606,4,2382
Clayton,LJ5,90.60%,92.00%,88.20%,90.80%,92.20%,91.00%,3451,39,88,51,1,179,283,1013,489,15,1800,3451,30,85,47,0,162,288,1006,466,16,1776
Clayton,LJ6,88.20%,90.40%,87.40%,88.60%,91.00%,88.00%,3708,39,130,78,2,249,276,1218,584,9,2087,3708,36,120,72,2,230,270,1207,559,8,2044
Clayton,LJ7,86.20%,82.90%,78.00%,87.80%,83.60%,79.10%,2779,62,156,35,2,255,221,756,218,6,1201,2779,58,146,29,2,235,222,746,209,5,1182
Clayton,MO1,86.20%,89.40%,87.10%,87.40%,91.50%,87.70%,3328,57,87,57,1,202,388,731,357,2,1478,3328,53,68,49,1,171,383,729,341,1,1454
Clayton,MO2,67.50%,61.60%,59.10%,72.10%,62.50%,65.60%,2081,77,280,109,2,468,112,449,226,2,789,2081,63,266,90,1,420,120,444,233,2,799
Clayton,MO3,75.20%,72.30%,72.20%,75.50%,73.00%,73.20%,2407,61,219,109,1,390,157,573,330,4,1064,2407,56,210,102,1,369,153,567,315,3,1038
Clayton,MO4,78.40%,76.40%,78.70%,80.00%,77.40%,77.70%,2112,50,138,72,0,260,182,446,261,3,892,2112,52,130,63,0,245,179,446,252,2,879
Clayton,MO5,88.70%,89.90%,84.60%,87.70%,90.60%,87.00%,3056,47,120,74,0,241,256,1065,582,3,1906,3056,40,109,78,0,227,265,1054,555,3,1877
Clayton,MO6,79.60%,85.10%,79.80%,79.90%,84.50%,82.00%,3030,70,159,105,1,335,275,907,410,5,1597,3030,61,163,98,0,322,272,888,389,5,1554
Clayton,MO7,82.40%,78.50%,84.40%,83.20%,78.70%,85.40%,2142,46,122,49,1,218,248,445,229,6,928,2142,42,120,45,1,208,246,443,223,6,918
Clayton,MO8,91.70%,92.80%,87.10%,92.30%,92.90%,87.10%,3185,39,85,48,1,173,260,1090,528,10,1888,3185,39,83,42,1,165,261,1080,506,10,1857
Clayton,MO9,87.40%,84.40%,75.70%,87.20%,84.80%,79.90%,1509,35,72,31,1,139,112,390,216,0,718,1509,28,69,30,0,127,110,384,205,1,700
Clayton,MO10,86.80%,82.20%,78.50%,86.30%,82.60%,80.90%,2342,41,164,42,0,247,147,757,276,3,1183,2342,35,158,41,0,234,146,752,259,2,1159
Clayton,MO11,89.30%,87.90%,84.60%,90.20%,88.40%,86.60%,2295,39,92,34,2,167,224,669,285,1,1179,2295,33,86,30,2,151,225,657,275,1,1158
Clayton,OAK1,95.30%,96.20%,90.50%,95.70%,96.80%,93.60%,2635,33,29,14,0,76,313,732,284,3,1332,2635,22,24,12,0,58,317,721,270,3,1311
Clayton,OAK2,91.50%,92.90%,90.50%,90.40%,94.20%,94.10%,1974,22,32,21,3,78,231,420,226,8,885,1974,14,26,22,1,63,233,420,208,8,869
Clayton,OAK3,95.40%,95.00%,96.50%,97.10%,95.50%,95.50%,2731,12,35,18,0,65,325,660,373,6,1364,2731,15,31,11,0,57,312,654,363,6,1335
Clayton,OAK4,93.30%,94.60%,91.80%,95.30%,95.00%,92.50%,4233,39,63,35,0,137,426,1111,485,9,2031,4233,34,58,23,1,116,423,1102,466,6,1997
Clayton,OAK5,91.20%,93.60%,90.90%,90.70%,94.20%,89.90%,1795,17,27,8,1,53,172,395,83,7,657,1795,19,24,8,1,52,172,390,78,7,647
Clayton,PH1,89.80%,89.90%,82.50%,89.90%,90.30%,86.00%,2895,47,116,64,1,228,226,1028,562,1,1817,2895,38,110,60,0,208,232,1026,536,1,1795
Clayton,PH2,81.60%,79.60%,73.20%,81.20%,80.30%,75.20%,3382,98,284,107,1,490,265,1107,475,5,1852,3382,90,271,106,0,467,268,1106,458,5,1837
Clayton,RD01,91.10%,93.20%,89.30%,92.50%,93.40%,90.30%,2330,20,61,42,1,124,167,834,431,8,1440,2330,18,58,34,1,111,170,820,417,7,1414
Clayton,RD02,94.30%,94.70%,88.80%,95.50%,94.60%,90.30%,3431,37,50,33,4,124,298,900,548,26,1772,3431,32,51,25,3,111,300,893,531,27,1751
Clayton,RD03,93.50%,94.90%,88.30%,93.80%,95.40%,88.80%,3650,44,59,42,0,145,325,1096,605,7,2033,3650,42,53,38,0,133,326,1089,572,6,1993
Clayton,RD04,90.10%,89.70%,91.20%,89.30%,89.60%,92.20%,4362,42,112,71,0,225,426,975,647,10,2058,4362,36,111,72,0,219,418,954,603,10,1985
Clayton,RD05,90.20%,91.80%,87.70%,89.30%,92.50%,87.50%,2970,44,72,46,1,163,309,809,422,12,1552,2970,43,65,47,1,156,297,806,392,12,1507
Clayton,RD06,84.50%,86.70%,83.60%,83.80%,87.00%,85.70%,3661,67,97,70,1,235,335,630,381,11,1357,3661,58,93,69,0,220,339,622,358,10,1329
Clayton,RD07,84.00%,83.60%,84.80%,83.50%,83.60%,88.80%,3020,53,99,60,1,213,288,505,315,14,1122,3020,38,97,60,1,196,297,494,303,13,1107
Clayton,RD08,89.50%,89.80%,87.30%,89.70%,90.70%,90.90%,2895,35,100,70,0,205,236,883,598,5,1722,2895,25,90,66,0,181,245,882,577,5,1709
Clayton,RD09,84.20%,89.40%,87.30%,84.50%,89.00%,88.60%,2653,40,84,70,0,194,267,707,374,7,1355,2653,35,86,66,0,187,267,694,359,6,1326
Clayton,RD10,96.10%,96.10%,94.70%,95.10%,96.40%,93.80%,3176,19,28,12,0,59,329,686,296,10,1321,3176,22,25,14,0,61,324,669,273,7,1273
Clayton,RD11,94.40%,95.20%,88.30%,94.50%,95.20%,89.10%,1881,21,31,19,0,71,157,620,323,1,1101,1881,20,31,18,0,69,163,617,311,1,1092
Clayton,RD12,90.30%,94.00%,81.60%,91.60%,95.10%,83.90%,3065,61,58,56,0,175,266,904,520,4,1694,3065,55,46,46,0,147,283,897,502,4,1686
Clinch,AB,100.00%,7.70%,9.70%,80.00%,15.40%,5.00%,108,56,12,0,0,68,6,1,5,0,12,108,57,11,1,0,69,3,2,4,0,9
Clinch,AG,29.20%,10.70%,16.70%,26.10%,11.00%,20.40%,367,95,108,17,0,220,19,13,7,0,39,367,90,105,17,0,212,23,13,6,0,42
Clinch,D,60.90%,18.80%,18.50%,60.90%,16.90%,18.30%,338,109,65,9,1,184,25,15,14,0,54,338,106,64,9,1,180,24,13,14,0,51
Clinch,F,27.30%,29.20%,7.70%,20.00%,26.10%,8.50%,270,144,17,8,0,169,12,7,3,0,22,270,140,17,8,0,165,13,6,2,0,21
Clinch,H,42.10%,22.90%,44.70%,36.90%,21.00%,41.30%,3262,214,1075,175,0,1464,173,320,127,0,620,3262,212,1067,178,0,1457,149,284,104,0,537
Cobb,AC1A,61.40%,45.10%,46.60%,60.10%,44.50%,43.90%,5458,260,1075,584,0,1919,224,883,927,3,2037,5458,264,1068,582,0,1914,204,857,876,3,1940
Cobb,AC1B,56.00%,42.00%,40.40%,54.80%,41.80%,41.40%,5214,411,990,538,2,1941,276,716,686,4,1682,5214,395,977,522,2,1896,277,702,634,4,1617
Cobb,AC1C,74.70%,61.60%,59.10%,74.30%,61.30%,59.60%,5110,208,689,285,1,1183,293,1107,840,9,2249,5110,199,686,278,1,1164,286,1085,803,9,2183
Cobb,AD01,60.10%,49.30%,36.10%,57.40%,47.50%,36.40%,2444,237,353,340,0,930,131,343,513,3,990,2444,232,367,350,0,949,130,332,472,3,937
Cobb,AU1A,84.10%,82.20%,70.00%,84.60%,82.90%,71.90%,5329,165,285,186,2,638,380,1312,981,10,2683,5329,151,267,173,2,593,381,1298,948,10,2637
Cobb,BF02,62.90%,46.20%,34.40%,59.70%,45.60%,35.30%,3127,312,499,315,1,1127,163,428,535,1,1127,3127,301,506,331,1,1139,164,425,490,1,1080
Cobb,BF03,68.30%,49.50%,40.40%,64.30%,49.10%,39.80%,2436,274,321,171,2,768,186,315,369,1,871,2436,269,318,191,2,780,178,307,344,1,830
Cobb,BF04,57.40%,43.40%,30.70%,55.30%,42.70%,31.50%,3646,456,611,378,1,1446,198,469,509,4,1180,3646,450,613,377,1,1441,204,456,466,3,1129
Cobb,BG01,53.70%,45.80%,41.30%,51.00%,45.70%,42.70%,2385,210,360,251,6,827,151,304,291,1,747,2385,205,357,254,6,822,156,300,264,1,721
Cobb,BG02,59.30%,46.70%,39.40%,57.90%,45.10%,38.10%,3236,295,558,376,2,1231,191,489,547,2,1229,3236,298,571,376,3,1248,184,470,518,1,1173
Cobb,BK01,70.30%,59.60%,46.40%,67.80%,59.40%,48.60%,4773,350,682,284,3,1319,299,1008,671,6,1984,4773,332,676,295,4,1307,312,988,622,6,1928
Cobb,BR01,63.90%,66.30%,60.80%,60.80%,66.50%,61.90%,2727,139,241,255,6,641,217,475,452,8,1152,2727,134,236,260,5,635,219,468,404,7,1098
Cobb,BR02,71.80%,68.80%,52.80%,70.80%,69.10%,52.50%,3894,181,402,345,1,929,200,886,880,4,1970,3894,180,394,347,1,922,196,883,843,4,1926
Cobb,BT01,94.80%,94.00%,86.50%,94.50%,94.00%,89.40%,2142,30,45,26,0,101,189,711,474,3,1377,2142,23,45,26,0,94,192,701,447,2,1342
Cobb,BT02,92.90%,93.10%,87.80%,92.40%,93.30%,90.20%,6209,73,110,61,0,244,520,1493,796,7,2816,6209,58,105,62,0,225,529,1472,753,7,2761
Cobb,BW01,66.90%,47.30%,47.00%,66.00%,45.90%,46.30%,2698,208,429,267,4,908,188,385,540,0,1113,2698,211,435,266,2,914,184,369,516,0,1069
Cobb,CA01,81.20%,74.30%,62.70%,80.00%,74.00%,62.90%,5969,257,494,231,4,986,432,1427,995,6,2860,5969,250,493,237,4,984,425,1402,947,5,2779
Cobb,CH02,56.30%,36.90%,29.40%,53.20%,35.50%,27.90%,3085,302,696,410,0,1408,125,407,529,1,1062,3085,307,698,430,0,1435,118,384,489,1,992
Cobb,CH03,60.10%,48.50%,33.30%,56.70%,47.30%,31.30%,4029,310,796,492,1,1599,155,749,741,0,1645,4029,315,811,524,1,1651,144,729,686,0,1559
Cobb,CK01,66.00%,65.30%,61.10%,65.00%,64.60%,61.60%,6065,312,617,419,1,1349,489,1160,815,3,2467,6065,303,622,410,1,1336,484,1133,760,3,2380
Cobb,CL01,67.00%,61.30%,51.60%,67.90%,61.80%,51.50%,1937,117,208,152,1,478,124,330,308,2,764,1937,114,203,138,1,456,122,328,292,0,742
Cobb,CL02,75.80%,72.90%,62.00%,75.20%,73.20%,63.80%,5372,275,476,277,2,1030,447,1278,866,5,2596,5372,257,463,274,1,995,448,1264,831,6,2549
Cobb,CO01,80.00%,79.60%,75.20%,79.40%,80.20%,77.70%,5252,140,320,234,0,694,421,1248,938,4,2611,5252,124,305,233,0,662,427,1236,896,4,2563
Cobb,CR01,56.30%,39.70%,29.90%,50.10%,36.60%,27.10%,3162,317,596,533,0,1446,135,392,688,0,1215,3162,328,621,605,0,1554,122,359,607,0,1088
Cobb,DC01,62.80%,40.30%,28.30%,57.50%,37.60%,25.50%,2828,258,543,402,6,1209,104,366,679,0,1149,2828,266,567,451,3,1287,91,342,610,1,1044
Cobb,DI01,75.70%,76.10%,68.80%,75.90%,75.70%,68.00%,3024,109,134,116,7,366,250,426,361,6,1043,3024,110,134,111,5,360,234,418,350,10,1012
Cobb,DI02,80.70%,74.70%,67.00%,78.70%,74.20%,68.50%,3984,183,295,132,1,611,367,869,553,7,1796,3984,173,291,138,1,603,371,839,509,7,1726
Cobb,DL01,67.80%,52.50%,42.50%,63.40%,50.90%,42.20%,3197,246,534,291,0,1071,178,591,612,4,1385,3197,247,553,324,0,1124,176,574,561,4,1315
Cobb,DO01,57.30%,43.40%,29.70%,52.70%,40.30%,25.40%,2100,237,358,324,2,921,100,275,434,1,810,2100,251,377,354,1,983,85,254,395,1,735
Cobb,DU01,49.10%,28.60%,21.20%,46.20%,27.50%,18.90%,4256,385,1339,557,2,2283,103,537,538,1,1179,4256,389,1349,565,2,2305,90,511,486,1,1088
Cobb,DV01,64.20%,46.30%,31.60%,61.00%,45.20%,31.30%,2093,310,340,207,0,857,142,293,371,1,807,2093,311,345,223,0,879,141,285,349,1,776
Cobb,EA01,58.80%,40.40%,30.00%,53.00%,38.00%,23.30%,3040,299,540,494,2,1335,127,366,705,2,1200,3040,330,559,549,3,1441,100,342,619,1,1062
Cobb,EA02,57.40%,42.50%,31.40%,51.70%,39.40%,27.80%,4074,301,689,706,2,1698,138,510,952,1,1601,4074,312,724,787,2,1825,120,471,843,1,1435
Cobb,EL01,76.80%,71.60%,59.90%,76.20%,71.30%,61.40%,4065,225,327,169,1,722,333,824,560,4,1721,4065,214,328,169,1,712,338,816,540,4,1698
Cobb,EL02,51.90%,45.50%,33.80%,49.20%,45.20%,31.40%,2434,256,381,383,2,1022,130,318,414,2,864,2434,257,382,393,3,1035,118,315,381,1,815
Cobb,EL03,51.40%,46.30%,29.50%,49.00%,45.40%,28.20%,2767,302,446,476,2,1226,127,384,503,0,1014,2767,303,447,490,2,1242,120,372,470,0,962
Cobb,EL04,73.30%,64.00%,53.70%,70.10%,64.00%,51.10%,3011,242,269,203,1,715,282,479,556,0,1317,3011,252,265,216,1,734,264,471,507,0,1242
Cobb,EL05,64.80%,47.10%,33.00%,61.20%,44.30%,29.90%,2884,327,444,332,0,1103,160,395,612,1,1168,2884,337,458,360,0,1155,143,365,567,1,1076
Cobb,EP01,67.20%,58.30%,43.80%,66.50%,56.90%,43.30%,2627,259,301,221,1,782,203,421,453,0,1077,2627,256,310,218,1,785,196,409,433,0,1038
Cobb,FO02,76.10%,73.20%,66.20%,75.70%,73.60%,69.00%,5779,251,396,304,5,956,495,1079,970,7,2551,5779,226,385,295,5,911,509,1071,921,6,2507
Cobb,FO04,71.00%,68.20%,64.60%,71.10%,68.60%,65.80%,5322,284,307,265,0,856,510,657,649,9,1825,5322,270,296,246,0,812,510,647,606,10,1773
Cobb,FP01,60.80%,42.80%,31.70%,57.60%,40.60%,29.90%,3452,341,602,493,0,1436,158,451,765,0,1374,3452,344,620,521,0,1485,147,424,709,0,1280
Cobb,FR01,49.70%,28.60%,22.00%,44.60%,26.90%,20.10%,3161,307,955,401,1,1664,87,383,396,0,866,3161,313,971,435,1,1720,79,357,350,0,786
Cobb,FY01,51.00%,29.70%,30.10%,49.40%,28.90%,28.60%,2582,172,812,303,0,1287,73,343,315,1,732,2582,170,812,301,0,1283,67,330,294,1,692
Cobb,GM01,62.30%,42.00%,31.60%,59.00%,40.60%,28.80%,2872,319,556,335,1,1211,148,403,554,0,1105,2872,328,567,349,1,1245,133,388,502,0,1023
Cobb,GT01,56.90%,42.00%,36.50%,54.50%,41.40%,35.60%,4033,433,671,473,1,1578,248,486,624,1,1359,4033,427,668,492,1,1588,236,472,590,1,1299
Cobb,HL01,87.10%,84.90%,72.80%,86.20%,85.40%,75.50%,6394,135,349,221,0,705,356,1969,1487,5,3817,6394,118,334,226,0,678,359,1946,1413,4,3722
Cobb,HR01,44.30%,28.50%,23.80%,42.40%,27.30%,23.70%,3122,333,875,457,0,1665,104,348,364,0,816,3122,334,879,464,0,1677,104,330,342,0,776
Cobb,HT01,56.80%,41.40%,25.50%,52.90%,39.40%,22.60%,4262,371,724,763,0,1858,127,511,1002,0,1640,4262,387,746,814,0,1947,113,486,916,0,1515
Cobb,HY01,49.80%,31.80%,26.70%,48.00%,30.20%,27.20%,4111,362,1055,596,1,2014,131,493,591,1,1216,4111,351,1081,608,0,2040,129,467,562,2,1160
Cobb,KE1A,56.80%,54.70%,49.40%,54.20%,55.10%,48.80%,2499,205,349,189,7,750,200,421,248,7,876,2499,204,341,190,8,743,194,419,225,8,846
Cobb,KE2A,62.40%,47.30%,40.80%,59.60%,45.50%,41.10%,3944,312,684,332,1,1329,212,613,550,4,1379,3944,304,695,344,1,1344,211,581,508,2,1302
Cobb,KE3A,70.20%,60.60%,57.00%,69.70%,59.70%,57.10%,6477,293,840,417,4,1554,390,1290,981,4,2665,6477,284,840,411,5,1540,383,1244,946,2,2575
Cobb,KE4A,61.50%,48.70%,45.00%,58.30%,47.30%,45.20%,3783,238,641,369,3,1251,197,609,590,0,1396,3783,238,651,384,1,1274,197,584,537,0,1318
Cobb,KE5A,69.60%,53.60%,42.60%,67.20%,53.00%,41.60%,5855,494,1021,420,1,1936,366,1181,961,1,2509,5855,496,1015,443,0,1954,351,1145,906,2,2404
Cobb,KL01,58.60%,40.40%,32.20%,57.60%,38.80%,32.90%,2006,295,325,233,0,853,139,220,330,1,690,2006,286,328,236,0,850,139,208,320,1,668
Cobb,KP01,46.00%,30.30%,25.40%,41.90%,29.70%,22.70%,1960,238,488,297,0,1023,81,212,253,0,546,1960,245,490,312,0,1047,72,207,225,0,504
Cobb,KP02,53.30%,42.60%,31.10%,51.20%,41.20%,27.30%,4049,364,830,567,4,1765,163,616,647,3,1429,4049,385,844,572,4,1805,143,592,600,3,1338
Cobb,KP03,45.70%,27.30%,19.10%,43.80%,26.50%,16.40%,3955,491,1150,543,3,2187,117,431,457,0,1005,3955,509,1168,551,2,2230,99,421,429,1,950
Cobb,LA01,57.50%,41.10%,26.80%,53.30%,39.80%,23.10%,3647,415,699,499,0,1613,150,488,676,2,1316,3647,440,715,539,0,1694,130,472,615,2,1219
Cobb,LI01,82.90%,80.50%,63.00%,81.10%,79.30%,61.30%,4797,168,351,250,0,769,284,1447,1209,2,2942,4797,174,370,268,0,812,274,1418,1148,2,2842
Cobb,LM01,53.50%,36.50%,35.40%,50.70%,34.60%,31.20%,3604,189,1030,491,1,1711,104,591,564,0,1259,3604,202,1051,511,1,1765,92,556,525,0,1173
Cobb,LM02,47.30%,29.80%,25.50%,42.60%,28.40%,22.20%,4121,344,1378,583,0,2305,118,586,523,0,1227,4121,358,1398,621,0,2377,102,555,461,0,1118
Cobb,LM03,52.60%,34.30%,33.80%,50.30%,32.50%,30.80%,5387,269,1658,660,1,2588,137,866,731,1,1735,5387,282,1698,659,1,2640,125,817,668,1,1611
Cobb,LM04,52.10%,34.00%,19.40%,50.10%,32.80%,21.30%,2629,257,725,330,1,1313,62,373,359,0,794,2629,248,733,337,0,1318,66,358,338,1,763
Cobb,MA01,73.10%,70.00%,63.80%,72.50%,70.10%,67.50%,5127,150,500,391,4,1045,272,1166,1060,0,2498,5127,135,491,384,3,1013,287,1151,1012,0,2450
Cobb,MA02,74.90%,74.10%,65.20%,74.40%,73.60%,66.40%,3330,137,217,180,0,534,257,622,537,0,1416,3330,130,217,178,0,525,257,605,516,0,1378
Cobb,MA03,62.00%,58.40%,50.00%,60.90%,57.90%,50.30%,3010,184,389,317,0,890,181,546,517,3,1247,3010,180,390,317,0,887,179,537,494,3,1213
Cobb,MA04,63.70%,57.20%,36.30%,59.20%,56.80%,34.10%,1581,137,218,194,0,549,78,291,341,0,710,1581,139,220,216,0,575,72,289,313,0,674
Cobb,MB01,52.80%,35.50%,22.30%,47.40%,34.10%,18.40%,1656,227,356,247,3,833,65,196,276,1,538,1656,245,365,266,3,879,55,189,240,1,485
Cobb,MC01,79.40%,73.50%,63.90%,79.50%,73.60%,64.80%,4213,153,394,212,0,759,270,1094,818,1,2183,4213,147,388,201,0,736,269,1083,778,2,2132
Cobb,MD01,58.90%,43.50%,29.10%,53.10%,41.80%,27.70%,4059,421,662,639,0,1722,173,510,915,0,1598,4059,431,679,715,0,1825,165,487,811,0,1463
Cobb,ME01,65.00%,60.40%,48.50%,64.20%,60.80%,48.10%,3549,152,538,362,1,1053,144,821,671,0,1636,3549,152,526,360,1,1039,142,815,645,0,1602
Cobb,MK01,60.40%,37.20%,23.50%,56.50%,35.00%,23.90%,1736,251,344,215,0,810,76,204,328,1,609,1736,251,349,232,0,832,78,188,301,1,568
Cobb,ML01,54.80%,32.20%,26.30%,50.70%,31.10%,24.80%,3290,368,847,376,2,1593,131,403,456,1,991,3290,370,859,398,2,1629,122,387,410,1,920
Cobb,MR1A,73.70%,69.90%,63.70%,71.50%,68.80%,63.60%,4468,194,313,198,1,706,335,727,555,7,1624,4468,188,321,209,1,719,324,707,524,6,1561
Cobb,MR2A,49.40%,46.00%,33.40%,46.20%,44.60%,30.90%,2059,255,356,332,0,943,128,303,324,0,755,2059,271,362,342,0,975,121,291,294,0,706
Cobb,MR2B,64.20%,63.30%,58.20%,61.10%,62.40%,56.40%,4447,244,503,396,2,1145,341,868,711,1,1921,4447,251,513,417,3,1184,329,851,654,0,1834
Cobb,MR3A,60.00%,54.50%,40.90%,56.90%,52.10%,39.20%,4388,317,624,512,2,1455,220,747,767,1,1735,4388,319,650,536,2,1507,206,707,707,1,1621
Cobb,MR3B,84.90%,82.70%,75.20%,84.50%,83.20%,78.10%,2218,57,105,79,0,241,172,503,443,1,1119,2218,49,99,78,0,226,174,490,424,1,1089
Cobb,MR4A,46.50%,33.80%,19.80%,39.70%,31.40%,13.90%,1956,384,367,329,0,1080,94,187,286,1,568,1956,422,378,368,0,1168,67,173,242,1,483
Cobb,MR4B,62.50%,55.70%,37.60%,56.00%,54.20%,36.00%,2056,184,273,226,0,683,110,343,377,1,831,2056,192,281,259,0,732,107,333,329,1,770
Cobb,MR4C,56.30%,36.40%,26.80%,53.30%,33.20%,23.80%,2781,268,657,369,0,1294,98,376,476,0,950,2781,288,687,387,0,1362,90,341,441,0,872
Cobb,MR5A,76.60%,70.20%,65.20%,72.90%,70.00%,64.90%,3324,158,249,182,0,589,289,586,597,7,1479,3324,155,247,200,0,602,282,577,537,5,1401
Cobb,MR5B,79.70%,78.90%,67.60%,81.10%,79.00%,69.60%,3084,133,144,107,1,385,276,540,421,3,1240,3084,124,142,97,0,363,281,533,417,3,1234
Cobb,MR6A,79.00%,77.50%,69.60%,79.00%,76.70%,69.30%,2647,114,160,98,2,374,263,550,368,3,1184,2647,111,162,92,2,367,252,532,347,3,1134
Cobb,MR6B,66.90%,54.20%,40.20%,63.40%,52.30%,37.90%,2910,238,425,307,0,970,160,503,620,0,1283,2910,247,439,329,0,1015,151,482,571,0,1204
Cobb,MR7A,81.00%,83.40%,71.90%,81.40%,83.40%,72.60%,3745,108,152,99,0,359,273,762,422,4,1461,3745,101,149,91,0,341,264,747,399,4,1414
Cobb,MS01,42.90%,21.70%,18.60%,41.20%,20.40%,18.80%,3633,430,1099,452,2,1983,99,305,339,0,743,3633,420,1101,452,2,1975,98,283,317,0,698
Cobb,MS02,61.40%,41.60%,31.90%,59.00%,41.10%,31.30%,2916,292,579,248,0,1119,137,412,394,0,943,2916,287,576,254,0,1117,131,402,365,0,898
Cobb,MT01,61.70%,39.40%,24.30%,53.90%,36.70%,21.80%,4125,385,737,634,4,1760,123,479,1022,2,1626,4125,405,772,755,3,1935,112,448,881,2,1443
Cobb,MT03,63.70%,42.20%,31.50%,57.30%,40.20%,30.20%,3294,209,651,439,0,1299,95,476,772,1,1344,3294,215,671,507,0,1393,92,451,679,1,1223
Cobb,MT04,57.20%,36.80%,28.20%,52.90%,34.70%,21.20%,2981,242,557,506,0,1305,95,324,675,0,1094,2981,267,574,553,0,1394,72,305,620,0,997
Cobb,NC01,62.50%,51.60%,35.90%,60.60%,51.90%,39.40%,2317,209,384,203,0,796,116,409,338,1,864,2317,195,374,204,0,773,126,404,314,1,845
Cobb,NJ01,82.10%,77.20%,67.90%,79.50%,76.30%,67.00%,4889,152,409,217,3,781,326,1385,993,2,2706,4889,153,421,239,2,815,311,1354,928,3,2596
Cobb,NP01,65.90%,61.10%,63.00%,63.10%,60.80%,63.50%,4922,220,487,434,1,1142,370,766,838,6,1980,4922,216,486,452,1,1155,369,754,773,8,1904
Cobb,NS01,58.00%,45.20%,30.70%,55.70%,44.80%,29.50%,2455,293,393,282,1,969,130,324,389,0,843,2455,293,389,288,1,971,123,316,362,0,801
Cobb,OK01,69.90%,62.70%,39.60%,65.30%,61.10%,38.10%,3944,258,475,397,0,1130,167,798,924,2,1891,3944,261,491,447,1,1200,160,772,840,1,1773
Cobb,OR01,53.30%,38.60%,34.00%,51.50%,37.90%,31.90%,1614,170,392,204,1,767,87,246,233,1,567,1614,172,390,206,1,769,81,238,219,0,538
Cobb,OR02,74.90%,76.80%,64.60%,74.60%,76.60%,66.60%,5671,226,386,377,0,989,409,1277,1123,3,2812,5671,212,381,366,0,959,419,1250,1074,3,2746
Cobb,OR03,72.30%,73.90%,69.30%,72.20%,74.10%,69.70%,5713,204,353,309,2,868,459,1000,808,7,2274,5713,196,342,293,3,834,450,978,761,8,2197
Cobb,OR04,77.10%,70.60%,64.30%,76.30%,69.70%,65.00%,4673,188,409,297,1,895,337,983,1001,4,2325,4673,180,417,295,1,893,332,961,951,4,2248
Cobb,OR05,69.20%,60.90%,38.20%,66.70%,60.60%,37.20%,3846,298,596,322,1,1217,185,927,723,0,1835,3846,298,597,337,1,1233,177,919,674,0,1770
Cobb,PE01,80.20%,82.20%,78.80%,81.00%,82.90%,79.80%,5218,114,286,227,2,629,427,1320,921,5,2673,5218,109,269,206,1,585,430,1306,881,5,2622
Cobb,PF01,61.30%,49.80%,36.90%,58.60%,48.80%,36.80%,3504,345,488,379,1,1213,198,484,601,4,1287,3504,338,502,393,0,1233,192,478,556,5,1231
Cobb,PM01,48.50%,32.40%,27.20%,45.90%,30.40%,25.70%,3491,348,943,486,2,1779,127,453,457,4,1041,3491,355,965,506,1,1827,118,422,429,5,974
Cobb,PM02,43.80%,28.60%,22.40%,38.20%,26.50%,17.80%,3127,384,834,532,0,1750,109,334,414,2,859,3127,400,855,572,1,1828,87,309,354,0,750
Cobb,PO01,56.40%,37.50%,28.00%,52.40%,35.00%,25.80%,3660,370,788,520,2,1680,143,472,672,2,1289,3660,381,807,556,4,1748,134,434,611,0,1179
Cobb,PP01,58.90%,38.60%,31.90%,55.10%,37.00%,31.10%,3153,254,640,455,0,1349,119,402,652,0,1173,3153,261,659,485,0,1405,118,387,595,0,1100
Cobb,PR01,51.70%,41.10%,32.10%,51.10%,41.00%,34.00%,2760,294,491,353,0,1138,139,342,378,0,859,2760,282,488,344,0,1114,145,339,359,0,843
Cobb,PS1A,77.40%,71.30%,58.30%,75.70%,70.60%,58.50%,4755,140,534,312,1,987,192,1328,1067,5,2592,4755,135,541,319,2,997,189,1300,995,4,2488
Cobb,PS2A,81.80%,80.80%,69.80%,80.60%,80.70%,71.20%,3536,94,228,141,0,463,214,957,632,3,1806,3536,84,224,145,1,454,208,935,602,2,1747
Cobb,PS3A,74.90%,73.90%,65.10%,73.20%,74.90%,68.40%,3991,134,387,210,0,731,249,1094,628,1,1972,3991,119,367,217,0,703,257,1095,592,1,1945
Cobb,PT01,59.20%,43.50%,35.30%,57.50%,42.20%,35.70%,2814,332,506,272,1,1111,181,389,395,1,966,2814,331,513,274,1,1119,183,374,371,1,929
Cobb,RM01,64.90%,39.60%,26.30%,60.30%,38.30%,23.10%,3390,463,620,357,1,1441,164,407,661,2,1234,3390,479,628,395,1,1503,143,390,601,1,1135
Cobb,RS01,91.10%,92.00%,81.60%,91.30%,91.80%,82.80%,2133,47,42,30,0,119,206,481,308,2,997,2133,43,42,28,0,113,205,473,293,2,973
Cobb,RW01,60.10%,38.40%,26.40%,55.50%,35.90%,24.70%,5374,487,1015,884,1,2387,175,633,1333,0,2141,5374,495,1051,964,1,2511,163,589,1200,0,1952
Cobb,RW02,63.30%,40.50%,29.30%,56.70%,36.90%,24.70%,3701,366,634,542,3,1545,153,432,933,0,1518,3701,396,669,626,3,1694,131,391,821,0,1343
Cobb,SA01,62.30%,48.40%,35.40%,60.80%,47.60%,33.70%,2933,295,460,362,0,1117,160,431,599,2,1192,2933,297,465,363,0,1125,150,422,563,1,1136
Cobb,SF01,59.70%,40.70%,27.10%,55.40%,37.20%,22.60%,3387,377,617,493,0,1487,139,423,731,1,1294,3387,404,653,541,0,1598,118,387,671,0,1176
Cobb,SI01,63.60%,47.20%,29.40%,59.40%,44.00%,26.10%,1868,172,354,211,1,738,72,316,368,0,756,1868,180,371,227,1,779,64,291,332,0,687
Cobb,SM01,63.90%,48.50%,33.90%,59.40%,45.40%,32.30%,3493,335,554,445,0,1334,172,522,787,0,1481,3493,337,577,488,0,1402,161,480,714,0,1355
Cobb,SM03,62.50%,63.70%,48.70%,59.80%,62.90%,48.40%,4759,359,436,450,4,1249,340,764,751,4,1859,4759,358,444,468,3,1273,334,753,696,4,1787
Cobb,SN1A,78.90%,79.90%,71.80%,77.30%,79.50%,72.00%,4152,158,211,183,2,554,404,841,683,3,1931,4152,155,212,191,1,559,400,820,651,2,1873
Cobb,SN2A,79.20%,76.70%,70.80%,77.70%,75.70%,73.00%,5539,167,403,278,1,849,407,1327,1056,1,2791,5539,151,415,288,1,855,409,1290,1002,1,2702
Cobb,SN3A,79.00%,68.40%,55.40%,74.40%,67.00%,53.60%,4573,204,472,248,1,925,251,1021,932,4,2208,4573,210,491,294,0,995,239,998,853,4,2094
Cobb,SN3B,68.80%,58.50%,47.70%,67.80%,56.00%,45.40%,2496,158,356,235,1,750,142,502,519,3,1166,2496,158,375,237,1,771,129,477,498,3,1107
Cobb,SN4A,66.30%,58.00%,44.90%,61.80%,56.10%,40.50%,5842,315,799,738,1,1853,252,1105,1452,6,2815,5842,342,835,823,1,2001,228,1066,1329,5,2628
Cobb,SN5A,78.10%,69.80%,61.10%,74.50%,69.60%,59.40%,4319,218,360,233,0,811,335,832,831,8,2006,4319,223,355,264,0,842,318,814,770,8,1910
Cobb,SN6A,68.10%,61.00%,47.90%,62.90%,59.00%,45.60%,5936,325,770,610,1,1706,291,1203,1305,9,2808,5936,343,806,691,0,1840,277,1162,1174,10,2623
Cobb,SN7A,78.90%,72.50%,51.60%,74.30%,70.60%,48.30%,6378,218,675,474,0,1367,231,1780,1773,1,3785,6378,231,720,560,0,1511,215,1728,1622,1,3566
Cobb,SO01,57.90%,41.70%,27.60%,51.80%,38.60%,26.20%,2163,266,356,347,1,970,102,255,478,0,835,2163,278,374,391,1,1044,99,235,421,0,755
Cobb,SO02,64.30%,49.80%,39.60%,57.20%,47.50%,33.80%,4729,331,740,560,1,1632,215,735,1010,3,1963,4729,368,775,655,2,1800,187,702,874,2,1765
Cobb,SO03,58.50%,44.90%,28.40%,52.70%,41.10%,25.10%,2886,320,498,395,0,1213,127,406,556,0,1089,2886,337,527,436,0,1300,113,368,486,0,967
Cobb,SW01,67.20%,62.90%,52.00%,66.20%,62.50%,53.30%,3235,191,431,245,0,867,206,731,501,1,1439,3235,184,431,248,0,863,209,718,485,1,1413
Cobb,SW02,77.40%,78.90%,73.90%,76.00%,79.10%,76.40%,3367,95,168,178,3,444,259,630,610,18,1517,3367,85,163,181,2,431,264,617,574,17,1472
Cobb,TM01,72.60%,71.50%,65.40%,69.50%,70.20%,65.20%,5816,247,433,350,0,1030,454,1084,927,12,2477,5816,241,446,378,1,1066,444,1050,862,9,2365
Cobb,TR01,64.00%,42.80%,26.30%,57.30%,39.60%,21.40%,2448,258,426,341,0,1025,91,319,605,1,1016,2448,275,456,399,0,1130,74,299,536,1,910
Cobb,VA01,51.30%,30.60%,23.10%,48.00%,29.10%,22.10%,3146,356,933,341,0,1630,107,411,359,0,877,3146,346,946,355,0,1647,98,388,328,0,814
Cobb,VG01,73.00%,73.40%,52.20%,69.60%,72.80%,50.60%,3260,191,272,236,1,700,208,751,637,2,1598,3260,198,277,257,1,733,202,743,589,2,1536
Cobb,VG02,69.40%,68.60%,58.40%,65.60%,67.40%,57.50%,6400,293,609,537,2,1441,410,1331,1217,4,2962,6400,293,629,589,1,1512,394,1301,1123,3,2821
Cobb,VG03,73.20%,67.90%,60.20%,67.90%,66.00%,58.40%,4407,158,492,349,3,1002,242,1040,952,2,2236,4407,165,516,404,3,1088,234,1003,853,2,2092
Cobb,VG04,56.30%,55.90%,34.40%,49.40%,52.20%,29.80%,3405,405,427,462,2,1296,213,542,595,0,1350,3405,432,463,526,2,1423,184,506,514,0,1204
Cobb,WG02,63.10%,52.60%,39.30%,61.10%,52.00%,41.00%,4718,413,741,450,1,1605,268,821,770,0,1859,4718,394,743,460,1,1598,275,804,724,0,1803
Cobb,WL01,59.70%,39.90%,27.20%,54.10%,37.30%,24.80%,2836,344,514,411,1,1270,129,341,609,0,1079,2836,356,536,463,1,1356,118,319,546,0,983
Coffee,1,55.40%,29.00%,40.60%,53.70%,28.20%,40.00%,17243,1061,4814,632,3,6510,728,1971,786,0,3485,17243,1043,4771,619,3,6436,698,1872,719,0,3289
Coffee,2,32.40%,17.60%,18.30%,29.80%,17.70%,18.80%,2053,361,651,92,0,1104,78,139,44,3,264,2053,358,639,92,0,1089,80,137,39,3,259
Coffee,3,56.30%,17.10%,24.30%,56.30%,17.30%,23.80%,344,115,68,7,0,190,37,14,9,0,60,344,112,67,7,0,186,35,14,9,0,58
Coffee,4,49.30%,17.60%,28.30%,51.00%,17.00%,28.40%,2398,352,770,76,2,1200,138,164,74,2,378,2398,340,764,70,3,1177,136,156,73,0,365
Coffee,5,55.60%,18.10%,20.50%,50.00%,18.40%,20.60%,2115,388,513,59,3,963,101,113,74,0,288,2115,374,493,63,3,933,98,111,63,0,272
Coffee,6,13.60%,3.80%,5.50%,17.20%,3.10%,6.10%,961,310,250,51,0,611,18,10,8,0,36,961,308,247,48,0,603,20,8,10,0,38
Colquitt,1,79.90%,63.80%,81.80%,80.20%,62.10%,80.40%,3487,79,268,82,0,429,354,472,326,0,1152,3487,84,274,75,0,433,344,449,304,0,1097
Colquitt,2,54.80%,33.70%,39.60%,51.50%,33.10%,39.50%,4809,345,1165,289,0,1799,225,593,350,1,1169,4809,338,1164,295,0,1797,220,576,313,1,1110
Colquitt,7,44.40%,19.70%,14.70%,42.50%,19.60%,15.80%,1512,260,415,69,2,746,45,102,55,0,202,1512,249,410,65,2,726,47,100,48,0,195
Colquitt,8,33.60%,7.90%,7.70%,31.20%,8.80%,8.10%,1191,274,444,75,2,795,23,38,38,0,99,1191,269,435,75,2,781,24,42,34,0,100
Colquitt,9,31.00%,35.40%,22.50%,28.60%,31.90%,21.60%,289,86,31,20,0,137,24,17,9,1,51,289,87,32,20,0,139,23,15,8,1,47
Colquitt,10,54.20%,24.10%,33.30%,60.40%,21.60%,34.10%,619,152,120,22,0,294,76,38,26,0,140,619,147,120,19,0,286,76,33,29,0,138
Colquitt,11,33.70%,15.50%,8.40%,30.00%,14.10%,9.10%,1030,279,268,63,3,613,26,49,32,0,107,1030,277,268,63,2,610,28,44,27,0,99
Colquitt,12,22.80%,10.10%,6.70%,19.60%,10.80%,5.80%,784,263,205,44,0,512,19,23,13,0,55,784,259,199,45,0,503,16,24,11,0,51
Colquitt,13,26.10%,8.70%,3.90%,17.40%,10.80%,5.00%,408,172,84,34,1,291,7,8,12,0,27,408,169,83,38,1,291,9,10,8,0,27
Colquitt,14,33.50%,14.00%,11.90%,29.00%,12.70%,11.10%,1670,264,598,107,2,971,35,97,54,1,187,1670,261,598,110,2,971,32,87,45,1,165
Colquitt,15,24.20%,17.40%,11.30%,24.20%,16.10%,11.80%,1094,211,275,72,0,558,27,58,23,0,108,1094,210,277,69,0,556,28,53,22,0,103
Colquitt,16,22.90%,7.70%,4.30%,20.50%,8.30%,4.50%,422,112,132,37,0,281,5,11,11,0,27,422,107,132,35,0,274,5,12,9,0,26
Colquitt,17,36.60%,14.90%,9.40%,40.30%,14.90%,9.50%,1555,345,446,97,0,888,36,78,56,0,170,1555,342,441,86,0,869,36,77,58,0,171
Colquitt,18,36.40%,10.40%,6.90%,34.50%,11.00%,7.80%,973,190,430,56,0,676,14,50,32,0,96,973,188,419,55,0,662,16,52,29,0,97
Colquitt,19,44.40%,19.30%,19.00%,45.90%,18.60%,19.30%,2586,404,678,144,0,1226,95,162,115,0,372,2586,394,676,139,0,1209,94,154,118,0,366
Colquitt,20,28.10%,15.10%,14.40%,24.20%,13.90%,14.50%,860,232,202,46,0,480,39,36,18,0,93,860,224,199,47,0,470,38,32,15,0,85
Colquitt,21,30.00%,6.30%,7.40%,26.30%,6.30%,5.70%,251,100,45,14,0,159,8,3,6,0,17,251,99,45,14,0,158,6,3,5,0,14
Colquitt,22,17.90%,11.60%,6.00%,19.40%,11.60%,3.90%,543,220,76,32,0,328,14,10,7,0,31,543,223,76,29,0,328,9,10,7,0,26
Colquitt,23,20.50%,11.30%,11.30%,22.10%,9.40%,10.30%,971,282,250,62,0,594,36,32,16,0,84,971,278,250,53,0,581,32,26,15,0,73
Columbia,10,38.10%,11.30%,7.90%,36.80%,10.70%,8.60%,2541,454,1149,179,0,1782,39,146,110,0,295,2541,449,1147,177,0,1773,42,138,103,0,283
Columbia,15,60.50%,36.10%,24.00%,59.00%,35.20%,24.70%,3737,410,1055,255,1,1721,129,596,390,1,1116,3737,408,1059,257,1,1725,133,574,370,1,1078
Columbia,16,51.50%,23.80%,13.70%,48.50%,23.60%,15.00%,1290,170,457,99,0,726,27,143,105,0,275,1290,164,453,101,0,718,29,140,95,0,264
Columbia,17,65.90%,34.00%,27.10%,62.80%,32.50%,26.90%,4046,349,1307,178,0,1834,130,674,344,0,1148,4046,348,1342,189,0,1879,128,647,319,0,1094
Columbia,18,71.80%,52.30%,42.00%,69.80%,50.90%,39.30%,4438,329,934,169,1,1433,236,1023,430,3,1692,4438,337,952,169,0,1458,216,988,390,2,1596
Columbia,20,43.30%,22.10%,18.30%,43.80%,21.30%,18.00%,2642,365,864,174,2,1405,82,245,133,0,460,2642,359,855,168,2,1384,79,231,131,0,441
Columbia,22,72.80%,34.70%,27.30%,71.60%,33.90%,26.40%,1819,307,451,69,0,827,115,240,185,0,540,1819,301,450,67,0,818,108,231,169,0,508
Columbia,24,44.50%,16.90%,13.70%,42.90%,15.70%,9.80%,1027,163,393,66,1,623,26,80,53,0,159,1027,165,392,64,1,622,18,73,48,0,139
Columbia,25,29.30%,12.20%,10.90%,32.50%,11.40%,8.00%,799,112,359,58,2,531,14,50,24,0,88,799,113,358,52,2,525,10,46,25,0,81
Columbia,26,63.30%,40.80%,36.40%,60.10%,39.30%,35.80%,2355,205,614,115,1,935,118,423,198,0,739,2355,208,622,118,0,948,115,403,178,1,697
Columbia,30,69.90%,48.50%,44.10%,68.30%,48.20%,45.30%,3410,279,646,137,2,1064,220,609,318,2,1149,3410,269,639,138,2,1048,224,595,297,0,1116
Columbia,31,71.30%,63.00%,57.50%,70.50%,62.40%,56.20%,2736,192,305,108,2,607,258,520,268,5,1051,2736,196,305,101,1,603,248,507,241,5,1001
Columbia,32,55.80%,39.70%,24.10%,54.40%,38.00%,25.20%,1701,249,371,117,0,737,78,244,148,1,471,1701,241,378,114,0,733,80,232,136,1,449
Columbia,33,75.60%,54.90%,48.00%,75.60%,53.40%,47.90%,3696,237,650,133,1,1021,219,790,413,1,1423,3696,237,659,126,1,1023,218,755,391,1,1365
Columbia,34,80.30%,56.50%,46.90%,77.50%,56.50%,46.10%,2954,179,523,80,0,782,157,678,327,1,1163,2954,179,515,84,0,778,152,668,290,1,1111
Columbia,40,52.20%,18.30%,18.10%,50.30%,18.40%,18.10%,1576,380,490,76,1,947,84,110,83,0,277,1576,374,491,74,1,940,83,111,75,0,269
Columbia,50,80.60%,33.50%,54.30%,79.40%,34.10%,53.00%,731,106,141,21,0,268,126,71,87,0,284,731,108,141,22,0,271,122,73,85,0,280
Columbia,51,32.30%,10.20%,8.70%,27.50%,10.50%,7.80%,1023,354,300,65,1,720,34,34,31,0,99,1023,353,298,66,1,718,30,35,25,0,90
Columbia,60,53.70%,30.10%,30.20%,51.80%,29.40%,29.40%,2143,224,692,150,2,1068,97,298,174,1,570,2143,220,688,149,3,1060,93,286,160,0,539
Columbia,61,58.00%,24.80%,18.80%,55.10%,23.00%,16.40%,3369,476,1180,212,3,1871,110,389,293,1,793,3369,493,1203,217,3,1916,96,359,266,1,722
Columbia,62,59.80%,33.20%,20.80%,57.90%,32.60%,20.70%,4596,579,1491,252,2,2324,152,741,375,1,1269,4596,587,1493,255,2,2337,153,722,350,1,1226
Columbia,63,60.50%,28.60%,28.60%,59.40%,26.80%,27.30%,1320,147,444,92,0,683,59,178,141,0,378,1320,149,457,89,0,695,56,167,130,0,353
Columbia,64,68.90%,41.20%,25.90%,65.90%,39.70%,24.10%,3558,404,961,161,0,1526,141,673,357,0,1171,3558,404,983,172,0,1559,128,646,333,0,1107
Columbia,65,51.80%,27.40%,22.70%,50.00%,26.60%,22.30%,2521,347,747,173,1,1268,102,282,186,0,570,2521,347,749,172,1,1269,100,271,172,0,543
Columbia,70,57.20%,42.40%,30.70%,55.60%,42.90%,30.70%,2026,244,413,137,2,796,109,304,183,0,596,2026,240,405,135,2,782,107,304,169,0,580
Columbia,75,55.40%,36.30%,26.50%,54.90%,35.50%,28.00%,2440,343,592,173,1,1109,123,338,215,1,677,2440,336,593,162,1,1092,130,327,197,1,655
Columbia,76,59.80%,33.90%,30.30%,57.20%,32.50%,28.90%,1937,317,382,133,0,832,138,196,198,0,532,1937,323,388,136,0,847,131,187,182,0,500
Columbia,80,46.40%,22.50%,22.10%,41.60%,21.40%,20.00%,1516,275,407,173,0,855,78,118,150,0,346,1516,276,412,181,0,869,69,112,129,0,310
Columbia,85,44.00%,24.80%,20.80%,42.10%,23.60%,21.60%,2836,447,783,251,2,1483,117,258,197,1,573,2836,441,785,252,2,1480,121,243,183,1,548
Columbia,90,52.40%,29.10%,21.70%,51.10%,28.60%,23.10%,2046,307,497,159,0,963,85,204,175,0,464,2046,299,494,158,0,951,90,198,165,0,453
Columbia,100,56.90%,32.50%,29.60%,54.70%,32.10%,27.70%,2179,319,515,169,0,1003,133,248,223,1,605,2179,323,510,175,0,1008,123,241,211,1,576
Columbia,105,44.40%,18.70%,21.20%,43.40%,18.00%,18.20%,1549,130,613,255,0,998,35,141,204,0,380,1549,139,615,248,0,1002,31,135,190,0,356
Columbia,107,64.30%,31.60%,32.00%,60.90%,30.20%,30.80%,2096,244,629,137,2,1012,114,291,247,2,654,2096,247,644,145,2,1038,110,278,226,1,615
Columbia,108,52.20%,28.50%,25.20%,49.40%,26.80%,22.00%,1830,243,522,172,0,937,81,208,188,1,478,1830,244,529,176,0,949,68,194,172,1,435
Columbia,109,54.70%,25.90%,23.00%,51.90%,24.80%,20.20%,2760,367,925,250,1,1543,110,324,302,0,736,2760,378,939,261,1,1579,96,309,282,0,687
Columbia,110,57.00%,33.50%,35.10%,55.10%,33.10%,33.30%,1291,198,238,71,0,507,106,120,94,1,321,1291,197,237,71,1,506,99,117,87,0,303
Columbia,111,66.00%,33.70%,29.30%,61.80%,33.70%,27.70%,1923,261,482,82,0,825,107,245,159,1,512,1923,263,483,86,0,832,100,246,139,1,486
Columbia,115,59.70%,40.00%,31.10%,56.40%,39.60%,31.70%,1962,324,337,106,0,767,146,225,157,0,528,1962,323,332,109,0,764,150,218,141,0,509
Columbia,120,35.70%,24.10%,21.40%,31.20%,24.10%,22.20%,1889,234,478,290,5,1007,64,152,161,1,378,1889,227,475,295,4,1001,65,151,134,1,351
Columbia,125,55.20%,34.30%,34.30%,54.70%,34.20%,34.00%,2310,309,481,191,3,984,161,251,235,2,649,2310,305,479,185,3,972,157,249,223,2,631
Columbia,130,55.60%,25.70%,23.90%,55.00%,25.30%,21.80%,2424,305,756,170,1,1232,96,261,213,0,570,2424,312,753,165,1,1231,87,255,202,0,544
Columbia,131,39.10%,17.80%,18.90%,37.60%,16.40%,18.50%,1268,160,503,142,3,808,38,109,91,0,238,1268,161,510,138,2,811,37,100,83,0,220
Columbia,132,49.20%,27.40%,23.80%,46.60%,26.10%,24.90%,2434,317,802,182,3,1304,99,302,176,1,578,2434,310,809,187,3,1309,103,285,163,1,552
Columbia,134,60.20%,30.40%,25.20%,56.70%,29.40%,26.00%,2106,193,679,131,0,1003,64,296,198,1,559,2106,191,683,136,0,1010,66,284,178,1,529
Columbia,135,56.10%,25.80%,21.30%,50.20%,24.50%,20.10%,2081,273,730,134,1,1138,73,254,171,1,499,2081,281,743,150,1,1175,70,241,151,1,463
Columbia,136,57.10%,32.60%,33.50%,55.20%,31.80%,32.30%,2301,270,606,142,0,1018,135,293,189,1,618,2301,264,606,143,0,1013,125,282,176,1,584
Columbia,137,51.40%,26.70%,18.10%,48.10%,25.70%,16.50%,2148,203,749,234,0,1186,44,273,247,1,565,2148,207,757,234,1,1199,41,262,217,0,520
Cook,C,69.60%,39.20%,43.80%,67.70%,36.50%,42.40%,1899,135,450,52,0,637,104,290,119,1,514,1899,136,461,53,0,650,99,265,111,1,476
Cook,DB,45.10%,18.10%,29.50%,44.50%,18.10%,31.50%,2446,206,897,146,0,1249,86,198,120,0,404,2446,200,890,141,0,1231,92,197,113,0,402
Cook,EP,96.10%,92.90%,93.20%,94.50%,90.00%,90.20%,531,6,8,3,0,17,82,105,73,0,260,531,8,11,4,0,23,74,99,69,0,242
Cook,L,33.70%,14.40%,24.70%,33.70%,13.80%,24.10%,1275,241,392,69,0,702,79,66,35,0,180,1275,239,387,65,0,691,76,62,33,0,171
Cook,M,41.70%,17.00%,13.00%,42.10%,16.70%,12.40%,919,100,386,35,0,521,15,79,25,0,119,919,99,380,33,0,512,14,76,24,0,114
Cook,NL,35.30%,11.50%,8.60%,33.30%,11.20%,9.10%,1233,235,471,55,0,761,22,61,30,0,113,1233,230,468,54,0,752,23,59,27,0,109
Cook,RB,25.70%,11.60%,12.00%,26.60%,11.90%,11.40%,1280,125,573,101,0,799,17,75,35,0,127,1280,124,565,94,0,783,16,76,34,0,126
Cook,S,75.00%,51.90%,67.20%,71.40%,50.00%,65.10%,1049,65,124,25,0,214,133,134,75,0,342,1049,68,126,28,0,222,127,126,70,0,323
Coweta,1,44.90%,21.60%,14.50%,41.30%,21.10%,13.70%,5838,1001,1779,643,0,3423,169,489,524,1,1183,5838,993,1770,661,0,3424,157,472,465,1,1095
Coweta,2,40.10%,16.10%,11.50%,37.40%,14.50%,11.60%,2758,905,578,285,0,1768,118,111,191,0,420,2758,895,579,286,0,1760,117,98,171,0,386
Coweta,3,30.40%,18.50%,8.20%,28.10%,16.80%,8.20%,2095,550,490,236,0,1276,49,111,103,0,263,2095,545,494,233,0,1272,49,100,91,0,240
Coweta,4,40.90%,18.50%,12.70%,39.60%,17.90%,13.40%,839,338,110,65,0,513,49,25,45,0,119,839,331,110,64,0,505,51,24,42,0,117
Coweta,5,73.50%,58.10%,50.80%,72.90%,57.30%,49.40%,3478,322,339,185,0,846,333,471,513,0,1317,3478,325,342,182,0,849,317,458,489,0,1264
Coweta,6,39.00%,17.90%,11.70%,38.50%,17.60%,12.30%,4526,881,1486,427,1,2795,117,323,273,0,713,4526,869,1476,414,1,2760,122,315,259,0,696
Coweta,7,46.40%,22.90%,20.70%,43.60%,21.40%,20.40%,4328,663,1310,450,0,2423,171,388,390,2,951,4328,661,1320,452,0,2433,168,360,349,1,878
Coweta,8,40.20%,20.60%,13.60%,39.00%,19.80%,12.90%,5330,984,1596,678,0,3258,155,414,456,0,1025,5330,972,1592,665,0,3229,144,394,425,0,963
Coweta,9,52.60%,28.30%,22.30%,48.60%,28.50%,22.70%,2572,687,367,164,1,1219,197,145,182,0,524,2572,672,357,171,1,1201,198,142,162,0,502
Coweta,10,43.60%,14.10%,11.10%,41.80%,13.50%,10.80%,2339,782,499,184,0,1465,98,82,142,0,322,2339,769,498,185,0,1452,93,78,133,0,304
Coweta,11,40.10%,22.10%,12.40%,39.60%,21.90%,12.90%,3212,1061,476,312,0,1849,150,135,209,0,494,3212,1041,470,302,0,1813,154,132,198,0,484
Coweta,12,47.90%,21.30%,14.00%,46.50%,20.20%,14.70%,3028,881,507,256,0,1644,144,137,235,0,516,3028,859,501,252,0,1612,148,127,219,0,494
Coweta,13,38.40%,16.60%,14.60%,37.40%,17.00%,14.10%,2492,608,663,253,0,1524,104,132,158,0,394,2492,604,650,241,0,1495,99,133,144,0,376
Coweta,14,40.30%,18.40%,14.10%,37.30%,18.30%,14.10%,4477,1015,1359,433,0,2807,166,306,292,0,764,4477,1002,1357,445,0,2804,165,304,265,0,734
Coweta,15,61.20%,42.30%,35.30%,60.00%,43.80%,35.50%,2559,417,353,179,0,949,227,259,282,1,769,2559,410,334,175,0,919,225,260,262,1,748
Coweta,17,72.60%,60.10%,61.90%,73.30%,59.30%,63.10%,4395,282,397,189,0,868,455,598,502,4,1559,4395,268,395,174,0,837,456,575,478,3,1512
Coweta,18,56.90%,38.70%,35.60%,54.40%,37.90%,34.80%,20465,2061,4622,1795,1,8479,1138,2923,2367,0,6428,20465,2064,4629,1814,0,8507,1102,2831,2164,0,6097
Coweta,19,51.50%,38.90%,28.10%,48.10%,36.90%,28.10%,2846,474,447,306,0,1227,184,285,325,1,795,2846,468,456,311,0,1235,182,267,288,1,738
Coweta,20,43.50%,29.00%,25.80%,38.50%,27.90%,23.60%,1974,448,345,235,0,1028,156,141,181,0,478,1974,456,351,240,0,1047,141,136,150,0,427
Coweta,21,50.10%,26.20%,25.00%,49.00%,25.40%,23.70%,4636,677,1306,395,1,2379,226,464,396,0,1086,4636,685,1304,386,1,2376,213,443,371,0,1027
Coweta,22,51.80%,32.10%,22.70%,48.50%,31.20%,21.40%,4462,705,1127,450,0,2282,203,534,484,4,1225,4462,709,1123,459,0,2291,189,510,432,4,1135
Coweta,23,39.70%,23.30%,14.00%,36.30%,20.90%,14.20%,3653,797,1003,388,0,2188,130,304,255,0,689,3653,789,1027,397,0,2213,131,272,226,0,629
Coweta,24,70.50%,58.60%,64.00%,72.10%,57.60%,66.10%,838,91,55,43,0,189,162,78,103,0,343,838,83,56,38,0,177,162,76,98,0,336
Coweta,25,49.20%,32.60%,27.30%,46.70%,31.60%,26.50%,2285,528,347,244,0,1119,197,168,236,1,602,2285,533,348,248,0,1129,191,161,217,1,570
Coweta,26,43.40%,19.50%,16.10%,41.00%,18.90%,16.00%,4962,844,1656,445,0,2945,162,401,341,0,904,4962,832,1641,448,0,2921,158,383,311,0,852
Coweta,27,39.20%,20.20%,20.50%,36.90%,19.80%,19.90%,1723,271,607,160,0,1038,70,154,103,0,327,1723,270,607,161,0,1038,67,150,94,0,311
Crawford,1A,63.60%,35.70%,38.10%,56.90%,35.10%,40.60%,516,65,101,24,0,190,40,56,42,0,138,516,63,98,28,0,189,43,53,37,0,133
Crawford,1B,72.70%,53.20%,51.50%,75.50%,52.50%,50.50%,1025,49,216,42,1,308,53,246,112,0,411,1025,48,215,37,1,301,50,238,114,0,402
Crawford,2,63.60%,38.10%,35.60%,63.20%,36.50%,37.50%,1659,121,467,103,0,691,66,288,180,1,535,1659,115,469,98,0,682,68,270,168,1,507
Crawford,3,31.70%,11.40%,14.30%,30.60%,11.60%,15.40%,1738,197,721,125,0,1043,33,93,58,0,184,1738,193,709,120,0,1022,35,93,53,0,181
Crawford,4,29.80%,9.90%,8.20%,28.60%,10.80%,9.10%,1805,359,622,144,0,1125,32,68,61,0,161,1805,351,609,135,0,1095,35,74,54,0,163
Crawford,5,36.40%,11.50%,9.80%,36.70%,12.00%,8.00%,1769,361,586,124,0,1071,39,76,71,0,186,1769,356,571,114,0,1041,31,78,66,0,175
Crisp,ARABI,40.60%,15.80%,18.10%,40.30%,14.60%,17.00%,785,163,255,41,0,459,36,48,28,0,112,785,161,258,40,0,459,33,44,27,0,104
Crisp,CONEY,30.80%,8.60%,9.20%,25.70%,7.90%,11.30%,859,128,415,81,0,624,13,39,36,0,88,859,125,418,84,0,627,16,36,29,0,81
Crisp,CORDE,63.30%,43.90%,63.90%,61.70%,41.60%,61.70%,8897,282,1759,444,3,2488,503,1379,766,1,2649,8897,292,1811,452,4,2559,476,1292,727,0,2495
Crisp,JAMES,24.60%,9.20%,7.10%,19.80%,9.10%,6.70%,1196,209,494,129,0,832,15,50,42,1,108,1196,208,492,138,0,838,14,49,34,1,98
Crisp,LISTO,14.10%,3.50%,2.00%,12.90%,4.20%,3.00%,817,195,304,85,0,584,4,11,14,0,29,817,192,298,81,0,571,6,13,12,0,31
Dade,1038,38.80%,18.30%,10.70%,38.50%,18.80%,12.60%,969,191,290,52,0,533,23,65,33,0,121,969,180,277,48,0,505,26,64,30,0,120
Dade,1214,40.40%,20.20%,13.10%,43.00%,20.40%,12.30%,1255,278,351,99,1,729,42,89,67,0,198,1255,277,339,90,1,707,39,87,68,0,194
Dade,1222,25.00%,6.40%,6.90%,22.40%,7.80%,8.90%,2012,430,701,84,1,1216,32,48,28,0,108,2012,409,659,83,1,1152,40,56,24,0,120
Dade,1885,26.50%,11.70%,9.40%,29.20%,12.80%,11.80%,711,213,151,50,0,414,21,20,18,1,60,711,201,143,46,0,390,26,21,19,1,67
Dade,1889,43.40%,22.70%,15.00%,38.30%,22.40%,15.20%,1237,278,269,82,0,629,49,79,63,0,191,1237,278,270,87,0,635,50,78,54,0,182
Dade,960,31.70%,14.30%,10.30%,29.00%,14.80%,12.20%,3573,336,1090,170,3,1599,39,182,79,0,300,3573,323,1066,169,2,1560,44,185,69,1,299
Dade,974,47.60%,21.80%,11.50%,47.40%,20.80%,13.50%,1903,284,562,98,2,946,37,157,89,0,283,1903,274,556,91,1,922,43,146,82,0,271
Dawson,1,44.90%,18.60%,8.10%,41.10%,17.90%,8.00%,2723,395,922,316,1,1634,35,211,258,0,504,2723,392,927,324,0,1643,33,202,226,1,462
Dawson,2,27.10%,9.30%,9.00%,25.30%,8.80%,8.90%,9891,934,4474,793,2,6203,93,461,295,0,849,9891,904,4413,769,2,6088,88,427,260,0,775
Dawson,3,36.80%,12.10%,11.10%,35.30%,11.30%,11.70%,8915,1007,3699,855,0,5561,126,509,498,0,1133,8915,983,3669,834,0,5486,129,467,455,1,1052
Decatur,1277,36.10%,9.70%,6.50%,37.50%,8.90%,5.00%,564,129,224,39,0,392,9,24,22,0,55,564,132,224,35,0,391,7,22,21,0,50
Decatur,1325,48.50%,18.40%,9.40%,49.20%,18.50%,10.60%,678,173,146,68,1,388,17,33,64,1,115,678,168,145,66,1,380,19,33,64,1,117
Decatur,1342,71.70%,16.20%,14.70%,69.50%,18.50%,15.70%,566,132,165,17,1,315,23,32,43,0,98,566,128,159,18,1,306,24,36,41,0,101
Decatur,1361,59.00%,22.10%,17.80%,59.60%,20.80%,16.70%,975,197,311,48,2,558,43,88,69,0,200,975,198,313,46,2,559,40,82,68,0,190
Decatur,1613,41.10%,15.60%,17.30%,42.50%,17.40%,20.10%,836,158,281,53,0,492,33,52,37,0,122,836,147,275,50,0,472,37,58,37,0,132
Decatur,1805,68.70%,40.10%,46.20%,65.60%,39.10%,47.00%,2238,120,586,91,0,797,102,392,200,1,695,2238,116,581,94,0,791,102,373,179,1,655
Decatur,513,57.90%,34.20%,46.70%,56.60%,33.40%,45.50%,5641,279,1737,328,1,2345,243,904,452,2,1601,5641,283,1737,320,1,2341,235,870,417,2,1524
Decatur,514,74.80%,46.00%,48.60%,73.40%,44.60%,49.70%,3308,162,741,106,0,1009,151,632,314,2,1099,3308,154,738,103,0,995,150,594,284,2,1030
Decatur,694,76.80%,57.70%,58.50%,75.20%,57.70%,57.00%,1812,119,260,82,1,462,167,355,271,2,795,1812,122,254,84,1,461,163,346,255,0,764
Dekalb,AA,88.00%,92.10%,84.10%,89.30%,92.40%,82.40%,2858,44,77,80,0,201,227,896,589,6,1718,2858,47,73,68,1,189,220,892,566,4,1682
Dekalb,AB,72.80%,50.50%,35.30%,65.30%,45.10%,29.00%,2432,191,543,156,0,890,103,553,418,1,1075,2432,213,601,194,0,1008,86,494,365,1,946
Dekalb,AD,59.90%,49.20%,23.30%,53.70%,43.80%,18.10%,2538,227,572,302,3,1104,69,555,452,1,1077,2538,242,635,345,3,1225,53,495,400,1,949
Dekalb,AE,85.10%,82.60%,54.10%,83.20%,80.30%,51.50%,2906,201,200,137,0,538,236,949,784,1,1970,2906,211,226,149,0,586,223,920,737,1,1881
Dekalb,AF,94.00%,94.10%,87.40%,93.40%,95.00%,88.20%,2536,27,39,29,2,97,188,626,452,14,1280,2536,25,33,30,2,90,187,621,428,14,1250
Dekalb,AG,74.70%,58.10%,25.60%,66.10%,53.20%,22.30%,2966,196,594,195,2,987,66,825,576,2,1469,2966,205,668,256,4,1133,58,758,500,2,1318
Dekalb,AH,74.30%,58.10%,38.00%,68.20%,55.10%,34.50%,3664,179,600,267,2,1048,106,832,772,5,1715,3664,188,644,319,2,1153,96,789,684,4,1573
Dekalb,AI,90.90%,89.90%,67.40%,90.10%,88.80%,68.50%,3151,56,127,95,0,278,112,1128,953,4,2197,3151,52,141,101,0,294,109,1115,916,4,2144
Dekalb,BB,95.20%,92.80%,83.30%,93.30%,91.50%,81.70%,4675,48,145,62,1,256,242,1864,1233,2,3341,4675,54,168,85,1,308,243,1820,1177,3,3243
Dekalb,BC,86.50%,80.10%,56.10%,83.80%,78.90%,52.40%,2965,118,198,130,1,447,152,796,836,0,1784,2965,127,211,150,1,489,141,788,776,0,1705
Dekalb,BD,75.00%,69.10%,42.90%,69.90%,66.00%,35.30%,1752,121,211,144,0,476,90,472,431,1,994,1752,139,232,167,0,538,76,451,388,0,915
Dekalb,BE,79.80%,60.90%,49.60%,73.00%,58.20%,44.10%,2428,115,387,112,1,615,110,604,442,4,1160,2428,127,415,145,1,688,98,578,392,3,1071
Dekalb,BF,72.70%,72.30%,65.30%,71.00%,71.20%,64.40%,2752,76,281,192,0,549,136,733,511,7,1387,2752,79,290,198,0,567,136,717,484,7,1344
Dekalb,BG,74.20%,68.30%,40.60%,69.80%,65.10%,36.50%,3122,153,311,276,5,745,106,671,794,2,1573,3122,163,344,313,4,824,93,641,722,3,1459
Dekalb,BH,75.60%,73.80%,51.70%,74.50%,73.00%,52.80%,2681,155,249,158,3,565,164,702,490,5,1361,2681,147,254,156,3,560,163,686,455,5,1309
Dekalb,BI,73.80%,57.40%,38.50%,69.10%,52.60%,31.50%,3444,243,657,211,1,1112,151,884,594,2,1631,3444,271,730,245,1,1247,123,810,549,2,1484
Dekalb,BJ,96.30%,96.80%,92.60%,95.90%,97.10%,94.10%,3829,24,49,34,0,107,295,1468,890,7,2660,3829,19,43,36,0,98,296,1463,847,5,2611
Dekalb,BL,95.80%,96.60%,91.70%,96.20%,95.90%,94.70%,2004,14,27,16,0,57,152,766,368,3,1289,2004,9,32,14,0,55,158,752,358,2,1270
Dekalb,BM,96.40%,95.90%,88.50%,96.00%,95.90%,91.60%,4838,39,58,37,4,138,314,1372,995,17,2698,4838,27,58,39,4,128,320,1356,946,16,2638
Dekalb,BR,94.70%,93.90%,81.70%,94.30%,93.20%,80.50%,3493,41,88,50,1,180,180,1348,897,7,2432,3493,41,97,53,2,193,171,1328,871,6,2376
Dekalb,CA,95.70%,97.20%,90.60%,93.40%,97.70%,94.20%,2526,23,17,21,0,61,213,590,469,8,1280,2526,14,14,30,0,58,220,591,428,8,1247
Dekalb,CB,94.60%,95.70%,93.70%,95.00%,96.00%,95.30%,2004,14,24,25,1,64,216,533,434,8,1191,2004,11,22,22,0,55,214,534,416,7,1171
Dekalb,CC,97.20%,94.80%,98.20%,96.10%,95.60%,97.50%,1794,3,18,7,0,28,148,325,244,13,730,1794,3,15,9,1,28,148,325,224,10,707
Dekalb,CD,97.50%,97.20%,89.60%,97.30%,97.30%,92.20%,4097,31,43,20,2,96,275,1471,777,9,2532,4097,23,40,21,2,86,286,1463,761,9,2519
Dekalb,CE,84.40%,66.10%,50.90%,81.60%,63.40%,50.50%,2231,109,310,75,1,495,112,604,406,2,1124,2231,109,332,85,0,526,109,574,376,2,1061
Dekalb,CF,91.90%,94.00%,88.70%,93.50%,94.10%,90.60%,3712,35,90,56,0,181,269,1408,636,7,2320,3712,29,87,43,0,159,273,1388,614,6,2281
Dekalb,CG,97.00%,97.30%,91.60%,96.80%,97.30%,92.80%,3349,22,34,22,1,79,245,1206,703,7,2161,3349,19,33,22,1,75,250,1189,676,7,2122
Dekalb,CH,83.30%,75.10%,62.00%,80.20%,74.20%,61.90%,2363,107,236,75,2,420,178,711,373,0,1262,2363,106,244,86,1,437,173,700,348,1,1222
Dekalb,CI,88.90%,88.30%,64.40%,86.70%,85.90%,60.00%,3264,69,156,138,0,363,121,1178,1101,4,2404,3264,75,188,163,1,427,111,1144,1059,3,2317
Dekalb,CJ,83.80%,82.00%,62.80%,81.40%,80.60%,59.80%,3223,93,184,178,0,455,150,837,924,7,1918,3223,99,197,199,2,497,146,821,873,4,1844
Dekalb,CK,89.50%,91.40%,87.10%,91.40%,90.80%,89.50%,3878,56,89,50,0,195,365,944,427,14,1750,3878,45,94,39,0,178,369,931,413,13,1726
Dekalb,CL,96.30%,95.30%,93.70%,95.60%,95.60%,94.30%,1731,8,26,13,1,48,129,525,341,5,1000,1731,8,24,15,0,47,128,519,323,5,975
Dekalb,CM,98.30%,95.20%,87.70%,99.70%,96.30%,90.50%,2178,21,30,6,0,57,143,599,353,7,1102,2178,16,23,1,0,40,146,594,336,6,1082
Dekalb,CN,93.20%,92.10%,84.50%,91.80%,90.60%,85.10%,4230,34,134,67,1,236,189,1566,923,2,2680,4230,32,159,79,1,271,186,1537,885,3,2611
Dekalb,CO,79.90%,66.10%,53.40%,74.40%,64.30%,48.30%,2260,96,260,123,0,479,106,507,490,4,1107,2260,104,275,153,1,533,95,496,445,3,1039
Dekalb,CP,95.30%,95.70%,91.90%,95.70%,96.10%,93.50%,2898,21,39,31,0,91,230,874,627,7,1738,2898,17,35,27,0,79,235,862,605,8,1710
Dekalb,CQ,96.70%,93.40%,83.90%,96.60%,93.40%,86.10%,3537,44,70,21,1,136,221,995,615,14,1845,3537,37,70,21,1,129,222,984,590,13,1809
Dekalb,CR,95.00%,96.10%,88.10%,95.10%,96.40%,89.30%,1896,17,20,14,0,51,123,493,265,3,884,1896,15,18,13,0,46,122,487,253,3,865
Dekalb,CS,95.30%,97.10%,92.60%,94.30%,97.30%,93.50%,3962,21,47,37,0,105,256,1569,755,6,2586,3962,18,44,43,0,105,254,1558,717,5,2534
Dekalb,CT,96.80%,93.50%,95.20%,94.90%,94.30%,91.70%,995,3,7,2,0,12,54,101,60,5,220,995,5,6,3,0,14,51,99,56,4,210
Dekalb,CU,91.10%,91.90%,70.90%,90.20%,90.70%,72.60%,2376,48,60,35,0,143,111,682,358,6,1157,2376,45,69,38,0,152,113,673,349,6,1141
Dekalb,CV,91.40%,86.80%,62.20%,87.40%,84.00%,55.60%,3226,52,169,109,2,332,87,1116,1165,2,2370,3226,60,205,159,3,427,78,1079,1107,1,2265
Dekalb,CW,80.30%,71.60%,50.70%,76.40%,69.20%,46.40%,3153,104,359,233,3,699,108,903,948,2,1961,3153,115,389,272,3,779,101,872,882,1,1856
Dekalb,CX,93.40%,91.70%,65.80%,92.00%,90.00%,60.30%,4018,52,154,94,0,300,98,1695,1328,2,3123,4018,60,185,112,0,357,89,1658,1281,2,3030
Dekalb,CY,88.80%,86.00%,75.70%,89.00%,85.70%,77.30%,2495,62,99,49,3,213,194,610,389,9,1202,2495,56,99,46,4,205,197,595,371,7,1170
Dekalb,CZ,76.40%,64.90%,43.30%,69.10%,61.80%,40.00%,3137,132,513,186,0,831,101,948,603,0,1652,3137,138,551,241,0,930,92,893,539,0,1524
Dekalb,DA,77.40%,77.30%,65.30%,76.60%,78.00%,66.70%,3065,138,210,121,4,473,262,716,415,5,1398,3065,130,199,121,4,454,265,706,396,4,1371
Dekalb,DB,78.60%,73.60%,53.80%,77.40%,73.90%,54.30%,1255,79,104,56,1,240,90,290,206,3,589,1255,78,101,57,1,237,91,286,195,3,575
Dekalb,DC,81.50%,72.50%,62.70%,79.50%,71.30%,61.10%,5141,188,463,209,6,866,322,1220,920,4,2466,5141,193,476,223,4,896,304,1185,863,6,2358
Dekalb,DD,93.90%,92.60%,69.80%,92.90%,90.40%,67.30%,1937,32,71,34,0,137,73,885,521,1,1480,1937,33,92,39,0,164,67,863,507,1,1438
Dekalb,DE,88.20%,88.30%,81.70%,87.50%,89.60%,82.20%,2268,40,81,56,1,178,177,614,418,6,1215,2268,37,70,57,2,166,175,606,398,5,1184
Dekalb,DF,76.50%,65.60%,54.00%,72.50%,62.50%,48.90%,3003,109,423,172,1,705,122,808,560,7,1497,3003,118,460,196,1,775,108,768,518,6,1400
Dekalb,DG,63.20%,53.60%,27.90%,55.80%,48.60%,21.00%,2044,120,468,202,4,794,46,541,347,2,936,2044,139,516,241,4,900,36,487,304,2,829
Dekalb,DH,86.70%,86.50%,59.10%,83.30%,83.60%,54.60%,2725,79,101,103,2,285,115,645,669,2,1431,2725,88,122,127,1,338,105,621,634,2,1362
Dekalb,DI,65.50%,46.30%,31.50%,54.50%,41.40%,22.90%,2570,99,733,238,1,1071,44,632,451,2,1129,2570,107,799,307,1,1214,31,565,368,1,965
Dekalb,EA,94.30%,90.90%,80.40%,94.10%,89.30%,78.20%,4139,51,151,57,1,260,206,1516,950,7,2679,4139,55,179,58,2,294,198,1489,917,6,2610
Dekalb,EC,74.90%,65.90%,50.70%,72.80%,63.40%,47.10%,1721,69,232,133,0,434,71,449,397,0,917,1721,73,251,140,0,464,65,435,374,0,874
Dekalb,EF,75.60%,68.70%,55.20%,72.00%,66.70%,55.80%,3441,145,398,216,0,759,174,873,671,5,1723,3441,141,424,245,1,811,175,848,631,4,1658
Dekalb,EG,88.30%,81.70%,61.20%,84.60%,79.50%,58.60%,3241,100,216,120,0,436,151,964,909,7,2031,3241,109,241,156,0,506,147,933,855,7,1942
Dekalb,ER,88.30%,92.00%,78.80%,85.90%,90.50%,79.60%,2290,34,55,59,0,148,119,636,444,7,1206,2290,32,65,67,0,164,118,621,409,7,1155
Dekalb,FA,95.40%,97.10%,95.00%,96.20%,97.20%,96.20%,5455,24,47,32,0,103,437,1575,659,21,2692,5455,18,45,25,0,88,436,1555,634,20,2645
Dekalb,FB,86.90%,81.90%,55.10%,81.80%,79.80%,48.90%,2125,77,144,117,2,340,95,652,774,2,1523,2125,88,162,161,3,414,86,638,722,1,1447
Dekalb,FC,98.00%,97.00%,92.80%,96.90%,97.10%,93.10%,2409,16,20,9,0,45,195,640,431,10,1276,2409,15,19,13,0,47,191,634,403,10,1238
Dekalb,FE,98.90%,96.60%,90.00%,98.50%,96.50%,91.10%,3449,22,46,9,0,77,191,1309,777,6,2283,3449,19,47,11,0,77,191,1302,747,4,2244
Dekalb,FG,96.20%,96.40%,90.70%,96.30%,96.60%,93.70%,3142,24,49,21,1,95,237,1317,538,6,2098,3142,17,46,20,0,83,245,1311,516,6,2078
Dekalb,FJ,98.30%,96.10%,89.40%,98.00%,97.10%,93.90%,2649,21,26,8,1,56,179,648,466,7,1300,2649,12,19,9,0,40,178,644,445,8,1275
Dekalb,FK,94.30%,95.60%,91.50%,95.40%,96.60%,93.00%,2103,10,34,26,1,71,112,741,433,6,1292,2103,9,26,20,0,55,112,740,412,7,1271
Dekalb,FL,97.50%,96.60%,92.70%,97.30%,97.10%,95.90%,2788,17,26,11,1,55,226,736,427,2,1391,2788,10,22,11,0,43,232,728,404,2,1366
Dekalb,FM,89.80%,91.90%,83.40%,89.20%,92.30%,85.50%,3227,55,75,63,0,193,265,850,557,11,1683,3227,48,70,64,0,182,273,840,529,11,1653
Dekalb,GA,91.30%,89.30%,62.80%,90.60%,88.00%,63.90%,2715,43,104,78,2,227,72,865,823,4,1764,2715,41,116,82,2,241,72,847,790,4,1713
Dekalb,GB,88.70%,92.70%,81.90%,88.80%,93.20%,84.10%,1880,46,38,39,0,123,204,485,306,4,999,1880,40,35,38,0,113,209,479,302,3,993
Dekalb,GC,95.60%,95.60%,90.00%,95.30%,95.80%,93.00%,3601,23,54,36,2,115,210,1168,787,16,2181,3601,16,50,37,1,104,212,1154,754,15,2135
Dekalb,GD,76.80%,67.60%,54.80%,73.40%,65.80%,52.60%,4155,160,548,181,4,893,192,1142,598,7,1939,4155,166,576,203,4,949,184,1109,561,5,1859
Dekalb,GF,91.90%,92.90%,88.50%,92.00%,94.00%,88.90%,2293,25,41,35,0,101,188,533,396,5,1122,2293,24,34,33,0,91,187,535,379,5,1106
Dekalb,HA,84.10%,86.70%,73.90%,85.40%,88.40%,77.60%,3776,96,163,114,1,374,264,1067,605,11,1947,3776,80,140,101,2,323,275,1072,592,9,1948
Dekalb,HB,81.90%,76.80%,63.90%,79.00%,75.40%,61.00%,3884,135,336,151,2,624,237,1111,681,5,2034,3884,144,355,170,1,670,222,1087,639,5,1953
Dekalb,HC,76.60%,69.10%,58.90%,70.70%,66.40%,52.40%,3104,104,373,210,0,687,147,836,686,2,1671,3104,119,402,255,0,776,129,794,616,2,1541
Dekalb,HF,80.50%,76.50%,63.60%,76.90%,74.90%,64.60%,3508,146,326,122,1,595,252,1059,503,5,1819,3508,140,345,139,1,625,252,1027,464,5,1748
Dekalb,HG,63.10%,68.50%,51.30%,61.00%,67.20%,50.70%,1773,113,222,180,1,516,120,482,308,0,910,1773,111,229,185,1,526,115,469,289,0,873
Dekalb,HH,97.00%,97.10%,89.50%,97.70%,98.00%,90.10%,4031,20,47,24,0,91,161,1583,783,10,2537,4031,19,33,18,0,70,162,1594,765,10,2531
Dekalb,HI,87.60%,86.80%,68.10%,85.00%,85.50%,64.60%,1462,51,71,45,1,168,107,467,318,4,896,1462,56,77,53,1,187,100,454,300,4,858
Dekalb,IA,82.30%,82.70%,66.20%,80.70%,82.90%,68.10%,2472,94,150,86,2,332,180,718,401,8,1307,2472,88,148,89,3,328,187,717,371,7,1282
Dekalb,IB,83.60%,84.60%,73.70%,83.70%,85.70%,73.70%,2318,51,90,69,5,215,147,496,352,10,1005,2318,52,83,66,3,204,143,498,340,11,992
Dekalb,JA,85.60%,80.70%,43.20%,79.30%,75.10%,36.00%,1600,50,124,95,0,269,38,519,565,0,1122,1600,57,161,133,0,351,32,486,510,0,1028
Dekalb,JB,82.40%,83.00%,68.70%,83.80%,82.80%,72.00%,3679,107,186,129,5,427,233,905,602,13,1753,3679,92,185,112,4,393,234,889,580,13,1716
Dekalb,KA,96.10%,95.70%,93.30%,95.70%,94.90%,93.40%,3015,20,34,24,0,78,275,760,589,3,1627,3015,19,40,25,0,84,268,742,563,3,1576
Dekalb,KB,61.30%,45.40%,30.60%,55.60%,40.80%,27.90%,2490,191,569,305,2,1067,79,474,484,6,1043,2490,200,614,346,4,1164,74,424,434,5,937
Dekalb,KC,97.30%,96.80%,86.70%,97.50%,97.50%,89.30%,1337,17,15,9,0,41,110,460,326,1,897,1337,14,12,8,0,34,116,460,317,1,894
Dekalb,KE,97.00%,94.20%,83.10%,96.80%,94.30%,83.90%,2546,48,41,15,1,105,230,669,477,11,1387,2546,46,40,15,0,101,229,667,452,11,1359
Dekalb,KG,71.80%,56.80%,34.40%,65.30%,51.60%,26.90%,2161,127,432,174,1,734,64,568,444,3,1079,2161,145,481,209,2,837,52,513,393,2,960
Dekalb,LA,71.90%,70.40%,48.70%,67.00%,67.30%,41.90%,3216,156,397,263,3,819,151,942,672,0,1765,3216,179,435,306,3,923,131,896,620,0,1647
Dekalb,LB,80.60%,74.40%,52.50%,76.80%,73.20%,50.70%,2223,95,183,153,1,432,102,532,637,4,1275,2223,99,190,182,1,472,99,518,602,4,1223
Dekalb,LC,78.60%,78.20%,60.80%,76.10%,75.90%,57.70%,3223,110,230,170,4,514,170,823,626,7,1626,3223,117,252,184,4,557,159,793,586,6,1544
Dekalb,LD,92.40%,92.70%,89.70%,92.80%,92.20%,90.50%,1730,25,30,18,1,74,225,381,220,2,828,1730,23,32,16,1,72,226,378,207,2,813
Dekalb,LE,91.40%,87.40%,62.00%,87.90%,85.20%,59.30%,3009,68,153,87,2,310,109,1057,929,5,2100,3009,74,179,121,3,377,108,1032,882,4,2026
Dekalb,LH,96.10%,97.30%,92.20%,96.90%,97.40%,96.10%,3610,28,30,22,0,80,320,1085,537,13,1955,3610,14,28,16,0,58,336,1066,504,12,1918
Dekalb,LV,74.00%,63.00%,45.20%,69.70%,60.70%,41.40%,1350,68,223,100,0,391,56,379,284,0,719,1350,75,235,116,0,426,53,363,267,0,683
Dekalb,MA,94.30%,93.70%,88.60%,93.80%,94.30%,89.60%,3455,38,63,42,0,143,286,934,700,8,1928,3455,34,56,45,0,135,285,932,676,7,1900
Dekalb,MB,95.50%,95.20%,85.20%,96.00%,94.60%,85.00%,4160,45,71,47,0,163,254,1419,988,6,2667,4160,46,80,40,0,166,256,1396,949,5,2606
Dekalb,MC,97.10%,97.40%,93.30%,97.00%,97.70%,94.30%,4234,21,38,19,3,81,315,1411,632,19,2377,4234,18,33,19,2,72,314,1393,607,19,2333
Dekalb,MD,97.50%,95.00%,89.20%,96.10%,94.80%,90.30%,2794,21,43,16,0,80,169,825,624,5,1623,2794,19,45,24,0,88,170,818,594,6,1588
Dekalb,ME,88.00%,80.70%,70.80%,86.50%,80.80%,73.20%,3607,69,233,121,0,423,157,973,885,10,2025,3607,62,230,131,0,423,159,966,840,10,1975
Dekalb,MF,97.40%,97.30%,87.10%,98.40%,97.30%,88.20%,2517,21,27,15,0,63,137,969,562,5,1673,2517,19,27,9,0,55,137,961,542,5,1645
Dekalb,MG,85.40%,83.90%,67.00%,83.60%,81.60%,61.60%,2208,65,128,115,0,308,130,665,674,2,1471,2208,75,145,125,1,346,121,644,635,1,1401
Dekalb,MH,65.70%,56.80%,37.60%,62.50%,54.70%,34.60%,2747,158,506,298,1,963,93,665,572,3,1333,2747,170,526,318,0,1014,86,636,531,4,1257
Dekalb,MI,96.40%,96.70%,93.90%,96.50%,97.20%,93.70%,4747,22,47,26,1,96,337,1377,696,14,2424,4747,21,39,24,2,86,332,1371,670,10,2383
Dekalb,MJ,93.30%,88.30%,74.00%,91.50%,88.00%,73.30%,2194,66,83,18,1,168,183,625,251,8,1067,2194,66,84,22,2,174,180,618,236,7,1041
Dekalb,MK,81.60%,81.70%,66.90%,80.70%,80.10%,65.40%,2586,86,174,114,1,375,172,778,505,4,1459,2586,90,187,115,0,392,166,753,482,4,1405
Dekalb,ML,95.20%,96.70%,88.00%,96.30%,96.80%,89.50%,3511,29,34,38,1,102,206,983,757,13,1959,3511,24,32,28,2,86,212,979,730,10,1931
Dekalb,MN,90.90%,91.80%,83.70%,90.70%,91.90%,84.80%,3138,45,65,37,3,150,229,729,371,17,1346,3138,42,64,37,2,145,228,722,360,18,1328
Dekalb,MO,93.60%,92.50%,85.60%,93.30%,92.80%,88.60%,3139,28,61,43,1,133,166,755,625,7,1553,3139,22,58,43,1,124,172,745,600,7,1524
Dekalb,MP,97.60%,96.60%,86.70%,98.00%,95.80%,87.70%,1900,19,22,11,1,53,126,627,456,4,1213,1900,17,27,9,1,54,126,618,443,2,1189
Dekalb,MQ,61.30%,48.60%,32.10%,55.50%,43.60%,28.20%,2651,187,662,258,1,1108,86,626,409,3,1124,2651,200,723,291,1,1215,76,559,363,3,1001
Dekalb,MR,95.10%,96.00%,93.60%,94.80%,95.70%,94.90%,2789,15,39,36,0,90,213,934,699,6,1852,2789,12,42,37,0,91,217,931,674,6,1828
Dekalb,MS,68.20%,55.50%,36.60%,62.30%,50.00%,30.90%,2303,105,515,176,6,802,59,642,378,5,1084,2303,115,577,203,6,901,49,578,335,5,967
Dekalb,MT,94.70%,94.10%,84.50%,93.30%,93.10%,85.70%,3405,29,86,43,3,161,166,1364,766,8,2304,3405,26,99,53,3,181,166,1343,737,8,2254
Dekalb,MU,72.30%,60.20%,38.40%,64.60%,55.20%,33.30%,2446,158,429,195,1,783,95,648,509,4,1256,2446,168,480,243,2,893,81,591,443,4,1119
Dekalb,MV,96.40%,94.50%,92.60%,97.00%,95.40%,92.70%,2151,14,42,19,0,75,170,725,505,4,1404,2151,14,35,15,0,64,175,725,479,4,1383
Dekalb,MW,85.80%,84.20%,75.30%,82.30%,83.20%,74.00%,1832,44,112,54,0,210,132,599,327,2,1060,1832,47,119,65,0,231,132,591,303,2,1028
Dekalb,MZ,96.10%,96.90%,93.00%,96.10%,97.10%,95.00%,3470,21,31,18,0,70,269,975,446,10,1700,3470,15,29,17,0,61,273,968,415,10,1666
Dekalb,NB,88.30%,89.10%,70.40%,85.50%,88.20%,71.80%,2166,44,75,69,3,191,102,613,520,10,1245,2166,39,81,81,3,204,97,603,478,10,1188
Dekalb,NC,89.40%,90.20%,83.50%,90.00%,91.20%,81.90%,2329,39,68,48,3,158,206,625,404,7,1242,2329,42,60,43,3,148,199,624,388,5,1216
Dekalb,ND,77.60%,79.40%,46.80%,75.10%,74.50%,43.30%,1509,99,112,112,0,323,86,433,389,1,909,1509,106,140,123,0,369,79,409,371,2,861
Dekalb,NF,77.80%,71.00%,59.30%,74.20%,70.00%,58.40%,1916,79,182,82,2,345,114,446,287,4,851,1916,79,186,94,3,362,112,435,270,3,820
Dekalb,OA,81.30%,69.30%,51.90%,77.00%,66.80%,43.40%,2253,115,269,140,1,525,125,607,609,0,1341,2253,137,288,167,1,593,106,579,558,0,1243
Dekalb,OB,71.40%,69.90%,71.50%,72.80%,70.80%,73.00%,2125,100,169,106,2,377,246,392,265,10,913,2125,93,163,96,2,354,248,395,257,9,909
Dekalb,OK,96.00%,93.80%,74.80%,92.70%,92.50%,66.70%,2398,34,69,31,0,134,98,1050,753,3,1904,2398,46,83,56,0,185,89,1026,713,3,1831
Dekalb,OV,97.20%,97.50%,94.30%,97.20%,97.50%,95.80%,5011,21,44,22,1,88,346,1725,759,19,2849,5011,14,44,21,2,81,351,1693,728,16,2788
Dekalb,PA,93.20%,91.20%,84.70%,93.80%,91.60%,85.60%,2458,30,59,32,0,121,161,610,442,5,1218,2458,28,55,28,0,111,161,599,421,5,1186
Dekalb,PB,76.90%,74.30%,61.30%,75.60%,74.20%,63.80%,3502,120,361,170,2,653,187,1045,565,6,1803,3502,111,356,172,2,641,193,1025,534,6,1758
Dekalb,PC,96.40%,95.10%,93.00%,96.40%,96.10%,94.60%,2376,13,43,17,0,73,168,840,455,6,1469,2376,10,34,16,0,60,168,845,434,6,1453
Dekalb,PE,90.00%,95.10%,86.50%,92.20%,96.40%,87.00%,632,34,7,8,0,49,218,135,72,0,425,632,33,5,6,0,44,220,134,71,0,425
Dekalb,PF,85.60%,84.30%,81.20%,85.90%,84.30%,81.40%,4538,94,204,95,1,394,399,1096,563,10,2068,4538,91,202,90,1,384,392,1087,547,10,2036
Dekalb,PG,92.60%,90.40%,70.00%,91.50%,88.80%,68.60%,3766,49,94,131,2,276,106,890,1631,13,2640,3766,49,111,143,1,304,97,876,1538,12,2523
Dekalb,PH,94.30%,94.40%,90.10%,94.60%,94.30%,91.00%,1586,14,28,20,0,62,125,468,333,2,928,1586,13,28,18,0,59,130,466,316,2,914
Dekalb,PI,94.90%,96.30%,94.80%,93.80%,96.30%,95.20%,2252,11,22,17,1,51,198,579,318,19,1114,2252,11,22,20,0,53,195,574,302,21,1092
Dekalb,PN,97.30%,92.90%,93.20%,98.00%,93.50%,91.20%,2018,11,40,10,1,62,159,524,354,5,1042,2018,16,36,7,0,59,159,520,335,7,1021
Dekalb,PR,98.00%,97.40%,93.70%,98.20%,97.20%,92.80%,2884,13,27,12,0,52,184,1011,587,9,1791,2884,15,29,10,0,54,184,997,557,8,1746
Dekalb,RA,94.70%,96.20%,91.30%,95.20%,96.40%,93.40%,3768,23,47,47,1,118,245,1204,846,7,2302,3768,17,45,41,1,104,247,1197,817,7,2268
Dekalb,RC,96.30%,96.90%,89.60%,97.40%,96.80%,92.90%,3020,23,36,23,1,83,199,1143,593,7,1942,3020,16,38,15,0,69,203,1135,571,7,1916
Dekalb,RD,77.30%,73.40%,36.20%,73.80%,72.00%,34.70%,1813,109,157,156,2,424,61,433,532,2,1028,1813,110,164,174,1,449,56,422,491,3,972
Dekalb,RE,92.80%,91.90%,87.50%,92.00%,92.70%,89.30%,3595,38,82,40,6,166,290,929,518,17,1754,3595,30,72,43,7,152,294,919,497,15,1725
Dekalb,RF,95.10%,95.70%,92.70%,96.50%,96.80%,94.80%,2910,16,49,26,1,92,209,1094,509,7,1819,2910,11,36,18,1,66,211,1097,498,6,1812
Dekalb,RG,93.30%,93.50%,89.60%,93.60%,93.80%,91.80%,3765,32,63,42,1,138,276,909,587,8,1780,3765,25,60,38,0,123,270,904,559,9,1742
Dekalb,RH,96.00%,96.90%,94.10%,96.80%,96.70%,94.40%,3990,17,41,31,0,89,252,1275,748,21,2296,3990,16,42,24,0,82,252,1250,724,19,2245
Dekalb,RI,96.10%,95.30%,89.70%,96.70%,96.00%,89.30%,3965,31,72,39,2,144,279,1464,964,8,2715,3965,32,61,32,2,127,277,1471,935,8,2691
Dekalb,RJ,90.60%,94.40%,83.60%,90.00%,94.90%,88.00%,2080,33,35,43,1,112,166,594,415,7,1182,2080,24,32,44,0,100,167,590,397,9,1163
Dekalb,RK,94.30%,95.90%,90.40%,94.80%,96.80%,93.30%,2932,24,38,31,0,93,215,878,515,12,1620,2932,16,29,27,1,73,224,873,495,12,1604
Dekalb,RL,90.10%,93.40%,88.90%,90.50%,93.70%,89.50%,4178,30,112,87,2,231,237,1592,789,18,2636,4178,29,106,80,1,216,239,1581,765,17,2602
Dekalb,RM,96.20%,94.80%,89.20%,96.00%,94.50%,91.50%,2496,17,47,21,1,86,143,860,527,5,1535,2496,13,49,21,1,84,147,844,503,4,1498
Dekalb,SA,76.40%,72.50%,50.50%,71.40%,68.60%,42.60%,2925,141,308,261,0,710,144,811,846,0,1801,2925,166,351,307,0,824,123,766,768,0,1657
Dekalb,SB,90.70%,83.90%,57.10%,88.60%,81.80%,56.50%,2805,68,150,93,2,313,92,780,910,1,1783,2805,69,168,111,1,349,90,754,864,1,1709
Dekalb,SC,92.50%,91.40%,84.00%,92.00%,92.10%,83.00%,2892,45,79,47,0,171,233,835,576,3,1647,2892,46,71,47,0,164,221,828,542,3,1594
Dekalb,SD,70.20%,81.60%,78.50%,67.80%,81.80%,82.80%,2338,39,111,234,0,384,139,492,551,3,1185,2338,30,108,241,0,379,141,486,507,3,1137
Dekalb,SE,72.30%,53.70%,42.50%,64.70%,49.20%,37.80%,4979,196,985,338,3,1522,143,1142,884,4,2173,4979,213,1074,416,4,1707,130,1042,761,2,1935
Dekalb,SF,71.60%,59.30%,41.90%,66.20%,54.80%,36.80%,2100,142,368,139,1,650,98,536,351,5,990,2100,157,407,164,3,731,88,493,321,5,907
Dekalb,SG,96.20%,97.30%,85.30%,97.80%,97.40%,88.60%,1894,25,17,20,1,63,151,611,507,0,1269,1894,19,16,11,1,47,155,604,493,0,1252
Dekalb,SH,66.90%,63.10%,36.50%,66.30%,62.90%,35.20%,2108,138,315,218,1,672,80,538,440,0,1058,2108,141,314,216,1,672,77,532,424,0,1033
Dekalb,SI,86.60%,92.30%,90.00%,85.30%,92.80%,89.70%,3247,32,50,48,1,131,280,600,311,17,1208,3247,33,46,51,1,131,279,597,297,16,1189
Dekalb,SJ,90.50%,93.40%,89.60%,91.60%,92.80%,90.90%,3714,39,47,47,0,133,320,663,446,16,1445,3714,33,51,39,0,123,317,656,426,12,1411
Dekalb,SK,95.00%,95.60%,90.20%,95.70%,96.40%,93.20%,4347,30,71,54,1,156,274,1542,1025,12,2853,4347,21,58,45,0,124,278,1546,1000,11,2835
Dekalb,SL,91.40%,93.10%,93.50%,92.50%,93.70%,92.60%,1988,12,36,23,0,71,162,488,244,10,904,1988,13,32,19,0,64,152,479,235,10,876
Dekalb,SM,97.00%,96.70%,91.10%,97.40%,96.70%,93.50%,3519,21,48,26,0,95,209,1391,830,6,2436,3519,15,48,22,0,85,212,1386,814,5,2417
Dekalb,SN,85.20%,76.20%,59.80%,82.80%,75.20%,59.50%,1600,82,134,83,0,299,116,429,478,6,1029,1600,81,137,94,0,312,113,416,451,6,986
Dekalb,SO,96.50%,96.60%,90.00%,97.00%,96.50%,93.20%,3470,27,44,23,1,95,241,1269,634,12,2156,3470,19,45,19,0,83,246,1256,621,13,2136
Dekalb,SP,90.30%,92.50%,79.40%,90.20%,92.30%,81.30%,3098,73,62,49,0,184,273,764,456,9,1502,3098,64,63,48,1,176,273,752,440,9,1474
Dekalb,SQ,88.40%,77.40%,78.00%,88.00%,78.50%,76.10%,1711,45,97,40,1,183,161,333,305,2,801,1711,48,92,39,1,180,154,336,285,2,777
Dekalb,SR,96.00%,94.30%,96.70%,95.30%,95.60%,96.30%,2705,8,41,20,0,69,232,683,474,6,1395,2705,9,31,22,0,62,228,679,444,6,1357
Dekalb,SS,97.60%,96.80%,83.80%,97.50%,96.60%,85.90%,1960,27,24,11,0,62,137,719,441,3,1300,1960,24,25,11,0,60,143,708,424,3,1278
Dekalb,ST,95.40%,95.30%,84.80%,95.60%,95.30%,86.60%,3822,49,68,37,0,154,271,1383,775,2,2431,3822,43,68,35,0,146,276,1371,756,1,2404
Dekalb,SU,95.60%,95.90%,92.10%,95.70%,96.50%,91.90%,3814,30,46,29,1,106,346,1072,630,16,2064,3814,30,39,27,1,97,341,1067,604,13,2025
Dekalb,SV,94.90%,93.40%,88.20%,95.10%,94.10%,90.60%,3555,32,83,43,1,159,242,1175,797,5,2219,3555,23,74,40,3,140,249,1172,769,3,2193
Dekalb,SW,96.70%,96.60%,87.60%,96.90%,96.50%,90.80%,3720,27,53,19,3,102,200,1518,555,12,2285,3720,19,54,17,2,92,196,1509,524,11,2240
Dekalb,SY,97.60%,96.90%,92.20%,97.70%,96.60%,95.20%,4872,18,71,27,0,116,201,2195,1092,11,3499,4872,11,76,25,0,112,206,2172,1062,11,3451
Dekalb,TA,96.60%,95.00%,89.60%,97.70%,95.30%,91.80%,2808,24,50,21,1,96,210,960,602,5,1777,2808,19,47,14,1,81,218,946,589,5,1758
Dekalb,TC,95.80%,96.90%,92.60%,96.40%,96.80%,93.20%,1729,12,15,16,0,43,145,468,365,6,984,1729,10,15,13,1,39,146,453,345,4,948
Dekalb,TF,71.60%,62.80%,40.30%,69.40%,61.30%,41.10%,3506,130,593,262,2,987,86,1000,661,3,1750,3506,130,609,276,2,1017,89,964,626,3,1682
Dekalb,TG,65.60%,50.20%,33.00%,60.40%,47.60%,29.80%,1552,119,354,135,1,609,59,357,258,0,674,1552,124,371,150,1,646,53,337,229,0,619
Dekalb,TH,73.90%,71.30%,61.40%,70.70%,69.90%,59.50%,2932,66,344,199,0,609,98,853,563,7,1521,2932,66,359,216,2,643,94,832,521,6,1453
Dekalb,VB,84.00%,83.20%,70.40%,83.10%,82.20%,69.80%,1037,46,57,47,2,152,111,282,247,3,643,1037,47,60,49,2,158,110,278,241,3,632
Dekalb,WA,97.00%,95.20%,94.20%,96.00%,97.20%,93.90%,3159,17,44,21,0,82,267,866,681,11,1825,3159,17,25,27,1,70,266,864,641,10,1781
Dekalb,WB,97.80%,96.40%,92.40%,97.40%,96.50%,94.30%,2922,14,41,16,2,73,190,1112,722,5,2029,2922,12,40,19,0,71,193,1099,698,6,1996
Dekalb,WD,91.70%,94.90%,91.60%,91.80%,95.40%,91.00%,3493,23,58,43,0,124,237,1083,472,13,1805,3493,24,52,41,0,117,231,1075,456,13,1775
Dekalb,WF,91.90%,91.20%,64.80%,90.00%,89.10%,58.60%,2020,25,84,53,0,162,44,868,604,2,1518,2020,29,104,64,0,197,39,847,576,2,1464
Dekalb,WG,93.00%,94.30%,94.00%,93.00%,94.50%,94.00%,3851,20,62,57,1,140,319,1025,757,12,2113,3851,20,59,54,1,134,316,1019,715,12,2062
Dekalb,WI,77.90%,73.30%,65.00%,75.30%,73.10%,61.10%,1364,72,115,61,0,248,132,316,215,2,665,1364,81,115,65,0,261,124,313,198,3,638
Dekalb,WJ,81.40%,75.40%,62.10%,79.40%,74.00%,63.00%,3193,76,288,176,2,542,126,883,768,2,1779,3193,76,303,189,2,570,131,861,727,2,1721
Dekalb,WK,96.60%,97.40%,91.70%,97.20%,98.00%,93.90%,2951,28,19,15,0,62,302,726,425,8,1461,2951,19,15,12,1,47,304,720,412,6,1442
Dekalb,WL,68.80%,52.30%,34.80%,62.80%,50.70%,30.10%,1434,121,286,124,1,532,63,314,273,2,652,1434,127,296,144,1,568,54,305,243,1,603
Dekalb,WN,94.80%,94.60%,86.50%,95.70%,94.50%,89.50%,3496,43,74,45,0,162,262,1306,813,13,2394,3496,33,75,35,0,143,270,1295,786,12,2363
Dekalb,YA,96.60%,96.60%,87.20%,97.20%,96.20%,93.60%,1951,14,27,15,1,57,95,761,426,7,1289,1951,6,30,12,1,49,96,756,411,6,1269
Dodge,CHAUN,22.20%,18.00%,18.80%,22.20%,18.40%,18.00%,412,147,73,28,0,248,34,16,8,0,58,412,146,71,28,0,245,32,16,8,0,56
Dodge,CLARK,0.00%,0.00%,6.10%,0.00%,0.00%,8.50%,111,46,19,5,0,70,3,0,0,0,3,111,43,19,4,0,66,4,0,0,0,4
Dodge,EDDIN,58.90%,27.00%,21.50%,56.30%,27.00%,23.50%,1037,197,292,51,0,540,54,108,73,0,235,1037,189,286,52,0,527,58,106,67,0,231
Dodge,EMPIR,22.90%,9.90%,5.60%,21.20%,10.90%,4.40%,456,153,109,27,0,289,9,12,8,0,29,456,151,106,26,0,283,7,13,7,0,27
Dodge,JAYBI,52.60%,42.90%,20.70%,44.40%,41.50%,20.90%,212,68,24,9,1,102,18,18,10,0,46,212,67,24,10,1,102,18,17,8,0,43
Dodge,JONES,26.50%,15.80%,9.50%,25.00%,15.40%,12.40%,436,133,117,25,0,275,14,22,9,0,45,436,127,115,24,0,266,18,21,8,0,47
Dodge,LEE,48.60%,34.00%,39.30%,46.00%,31.80%,37.50%,4816,362,1285,312,3,1962,235,663,295,1,1194,4816,368,1295,307,4,1974,223,603,262,0,1088
Dodge,MCCRA,39.30%,21.20%,8.60%,35.70%,22.60%,6.90%,293,106,67,17,0,190,10,18,11,0,39,293,108,65,18,0,191,8,19,10,0,37
Dodge,MILAN,42.90%,13.70%,14.70%,42.30%,15.10%,16.30%,332,110,63,16,0,189,19,10,12,0,41,332,108,62,15,0,185,21,11,11,0,43
Dodge,MITCH,53.10%,19.60%,12.20%,56.70%,19.30%,10.90%,333,115,90,15,0,220,16,22,17,0,55,333,114,88,13,0,215,13,21,17,1,52
Dodge,MULLI,21.90%,24.10%,18.90%,22.00%,25.60%,18.50%,505,180,60,50,0,290,42,19,14,0,75,505,172,58,46,0,276,39,20,13,0,72
Dodge,PLAIN,39.50%,10.80%,5.00%,34.30%,10.80%,6.30%,454,152,124,23,0,299,8,15,15,0,38,454,150,124,23,0,297,10,15,12,0,37
Dodge,PONDT,42.70%,17.80%,17.40%,41.20%,17.70%,16.10%,689,200,139,59,0,398,42,30,44,0,116,689,198,135,57,0,390,38,29,40,0,107
Dodge,RAWLI,50.00%,23.30%,16.20%,45.50%,21.60%,15.20%,923,171,257,52,0,480,33,78,52,0,163,923,173,258,55,0,486,31,71,46,0,148
Dodge,VILUL,42.90%,7.90%,1.10%,42.90%,2.60%,0.00%,170,90,35,8,0,133,1,3,6,0,10,170,87,37,8,0,132,0,1,6,0,7
Dodge,YONKE,30.00%,13.30%,10.30%,25.00%,15.60%,8.70%,260,105,39,14,0,158,12,6,6,0,24,260,105,38,15,0,158,10,7,5,0,22
Dooly,10,70.00%,42.00%,53.80%,68.40%,41.90%,50.90%,536,54,102,18,0,174,63,74,42,0,179,536,56,100,18,0,174,58,72,39,0,169
Dooly,2,61.40%,43.90%,46.30%,60.20%,44.70%,45.40%,609,95,101,34,0,230,80,79,54,2,215,609,95,99,35,0,229,77,80,53,2,212
Dooly,5,61.00%,43.50%,52.00%,60.30%,42.40%,52.50%,1634,145,318,82,2,547,159,245,128,0,532,1634,142,319,79,2,542,159,235,120,0,514
Dooly,7,71.60%,40.40%,63.90%,69.30%,40.00%,60.30%,2696,83,753,90,0,926,147,511,227,0,885,2696,89,746,92,0,927,135,498,208,0,841
Dooly,8,41.70%,21.10%,26.80%,33.30%,19.40%,26.50%,474,89,157,35,1,282,33,42,25,0,100,474,85,158,42,1,286,31,38,21,0,90
Dougherty,1,57.80%,50.50%,40.90%,55.30%,49.60%,39.90%,2761,321,295,182,6,804,220,301,249,6,776,2761,324,296,182,6,808,214,291,225,5,735
Dougherty,2,61.10%,66.40%,59.00%,61.00%,66.00%,59.40%,3205,263,267,192,0,722,379,528,301,0,1208,3205,257,265,181,1,704,378,515,283,0,1176
Dougherty,3,62.90%,57.90%,44.40%,61.30%,57.70%,43.40%,2334,318,209,128,0,655,252,288,217,2,759,2334,321,210,128,0,659,244,287,203,2,736
Dougherty,4,64.40%,50.40%,39.90%,62.30%,49.70%,39.30%,3885,399,666,324,5,1394,264,678,585,4,1531,3885,399,673,333,5,1410,258,665,551,4,1478
Dougherty,5,61.70%,61.60%,49.30%,59.50%,61.00%,51.40%,3394,323,432,265,0,1020,314,692,427,0,1433,3394,306,434,272,0,1012,324,680,400,0,1404
Dougherty,6,59.50%,48.50%,40.70%,57.10%,48.60%,40.60%,2432,318,329,167,2,816,211,310,245,9,775,2432,316,327,173,3,819,212,309,230,6,757
Dougherty,7,83.20%,79.30%,78.70%,81.90%,78.00%,77.90%,4289,128,246,125,3,502,479,941,617,6,2043,4289,133,259,130,3,525,472,918,587,6,1983
Dougherty,8,95.30%,95.30%,92.80%,94.60%,94.00%,92.20%,3265,39,31,33,0,103,499,632,673,1,1805,3265,42,39,37,0,118,496,616,643,1,1756
Dougherty,9,60.60%,47.30%,32.50%,61.90%,46.30%,34.60%,1465,271,167,110,1,549,129,150,169,2,450,1465,260,168,103,1,532,136,145,167,2,450
Dougherty,10,97.80%,97.80%,96.20%,96.30%,97.20%,95.00%,3638,22,13,14,0,49,557,569,634,2,1762,3638,29,16,23,0,68,547,556,604,2,1709
Dougherty,11,97.70%,99.40%,92.50%,95.60%,99.40%,93.90%,750,10,1,5,0,16,123,162,209,0,494,750,8,1,9,0,18,124,164,196,0,484
Dougherty,12,96.70%,97.50%,96.30%,96.20%,97.50%,93.00%,1667,9,4,8,0,21,229,155,236,3,623,1667,17,4,9,0,30,223,153,226,3,605
Dougherty,13,95.80%,89.60%,95.70%,94.60%,86.70%,94.20%,1510,12,20,10,0,42,264,172,227,0,663,1510,16,25,12,0,53,258,163,209,0,630
Dougherty,14,96.70%,94.10%,95.20%,94.30%,92.90%,91.40%,1486,11,12,7,2,32,236,192,208,20,656,1486,22,14,12,1,49,225,183,199,21,628
Dougherty,15,87.20%,82.40%,72.80%,86.50%,81.20%,69.20%,1574,65,33,27,0,125,173,154,184,1,512,1574,74,34,27,0,135,165,147,173,1,486
Dougherty,16,95.70%,96.20%,91.90%,89.90%,94.60%,91.70%,1205,10,3,3,0,16,108,76,67,6,257,1205,10,4,7,0,21,105,70,62,6,243
Dougherty,17,97.40%,98.20%,96.10%,95.70%,96.40%,95.40%,2549,16,6,10,0,32,398,328,374,1,1101,2549,19,12,16,0,47,391,318,352,0,1061
Dougherty,18,90.40%,90.80%,87.20%,89.80%,91.60%,86.90%,2404,48,38,30,1,117,329,374,282,4,989,2404,50,34,30,0,114,326,369,265,5,965
Dougherty,19,71.30%,82.10%,60.30%,69.50%,82.10%,61.90%,693,62,26,31,0,119,94,119,77,0,290,693,59,26,32,0,117,96,119,73,0,288
Dougherty,20,70.90%,59.70%,34.40%,70.10%,58.80%,35.00%,2819,503,223,129,1,856,264,331,314,0,909,2819,490,227,129,1,847,264,324,302,0,890
Dougherty,21,83.90%,74.20%,56.70%,83.40%,74.60%,55.50%,1042,84,65,36,0,185,109,187,188,1,485,1042,85,62,36,0,183,105,182,181,1,469
Dougherty,22,88.50%,89.00%,84.20%,85.90%,87.60%,83.40%,2965,86,48,48,1,183,462,389,369,3,1223,2965,89,53,57,1,200,449,376,348,3,1176
Dougherty,23,73.10%,70.70%,55.00%,71.80%,70.20%,55.50%,2221,217,128,112,0,457,265,309,304,0,878,2221,210,128,112,0,450,262,302,285,0,849
Dougherty,24,93.30%,92.50%,93.80%,93.50%,92.30%,90.40%,1963,23,22,18,0,63,344,271,252,4,871,1963,35,22,17,0,74,326,265,245,4,840
Dougherty,25,54.60%,47.60%,19.10%,52.60%,45.80%,19.20%,1879,445,291,178,0,914,104,264,214,1,583,1879,443,300,181,0,924,104,253,201,1,559
Dougherty,26,96.70%,93.40%,89.30%,96.60%,93.30%,88.70%,1098,21,14,9,0,44,170,199,262,6,637,1098,21,14,9,1,45,168,196,253,4,621
Dougherty,27,46.90%,45.30%,39.70%,45.40%,44.50%,40.60%,1505,226,227,153,0,606,148,188,135,1,472,1505,222,231,154,0,607,151,185,128,1,465
Dougherty,28,97.10%,98.80%,95.60%,96.90%,97.60%,92.90%,1174,9,2,1,0,12,193,165,33,1,392,1174,14,4,1,0,19,183,163,31,1,378
Douglas,1258,68.50%,52.30%,49.50%,67.40%,52.20%,49.50%,6745,432,1105,430,2,1969,421,1211,935,4,2571,6745,422,1089,425,1,1937,411,1188,880,3,2482
Douglas,1259,60.00%,57.60%,58.80%,60.50%,57.00%,60.80%,1911,105,304,120,0,529,148,413,180,2,743,1911,98,306,113,0,517,150,406,173,2,731
Douglas,1260,48.30%,21.50%,19.30%,47.90%,21.10%,18.50%,4915,410,1991,437,0,2838,98,544,409,0,1051,4915,406,1977,429,0,2812,92,529,395,0,1016
Douglas,1270,90.10%,89.10%,83.70%,91.40%,89.30%,84.40%,4076,76,117,60,0,253,388,952,548,1,1889,4076,71,113,49,0,233,383,948,520,1,1852
Douglas,1271,43.50%,21.00%,15.40%,41.10%,21.40%,16.70%,3930,570,1327,385,0,2282,104,353,297,0,754,3930,555,1322,387,0,2264,111,361,270,0,742
Douglas,1272,57.80%,38.80%,38.10%,57.20%,38.70%,39.20%,5459,357,1381,443,1,2182,220,876,606,0,1702,5459,344,1370,432,0,2146,222,864,577,0,1663
Douglas,1273,64.10%,56.60%,55.40%,63.00%,56.80%,56.40%,3847,229,552,259,0,1040,284,720,462,0,1466,3847,220,542,258,0,1020,285,712,439,0,1436
Douglas,1274,61.40%,51.10%,49.20%,60.70%,50.20%,49.20%,1966,132,297,150,2,581,125,310,239,5,679,1966,129,298,144,1,572,122,300,222,4,648
Douglas,1275,86.40%,81.90%,80.10%,86.70%,82.10%,81.70%,6033,91,407,176,0,674,365,1843,1121,2,3331,6033,83,399,164,0,646,368,1829,1072,2,3271
Douglas,1276,68.00%,56.40%,58.20%,66.60%,56.20%,58.10%,3042,114,483,151,1,749,160,626,321,0,1107,3042,111,477,150,1,739,155,612,299,0,1066
Douglas,729,86.60%,86.20%,81.50%,86.70%,86.30%,83.40%,5634,96,256,143,2,497,431,1605,922,2,2960,5634,85,251,133,1,470,430,1576,869,2,2877
Douglas,730,72.10%,66.80%,70.00%,70.00%,66.20%,71.00%,5675,143,582,289,0,1014,330,1170,745,4,2249,5675,135,579,296,0,1010,326,1135,692,4,2157
Douglas,731,57.10%,50.00%,47.20%,57.00%,49.90%,47.60%,3500,247,604,279,1,1131,222,603,372,0,1197,3500,237,600,266,1,1104,216,598,353,0,1167
Douglas,732,89.30%,85.20%,82.40%,89.50%,85.40%,84.00%,3208,66,150,63,0,279,309,865,524,1,1699,3208,60,146,58,0,264,313,853,495,1,1662
Douglas,733,75.10%,69.40%,63.20%,76.10%,68.30%,64.20%,2990,142,304,132,1,579,237,691,399,9,1336,2990,135,311,123,1,570,236,671,392,8,1307
Douglas,734,59.40%,39.70%,36.50%,58.10%,39.60%,36.80%,2703,248,560,199,1,1008,142,368,291,1,802,2703,243,557,199,1,1000,141,365,276,1,783
Douglas,735,60.30%,40.10%,37.70%,59.00%,39.80%,38.60%,3901,309,753,280,0,1342,186,504,425,1,1116,3901,291,748,276,0,1315,182,494,397,1,1074
Douglas,736N,83.90%,70.00%,63.50%,82.90%,70.80%,66.30%,4016,140,491,136,0,767,238,1146,708,6,2098,4016,129,472,139,0,740,248,1142,676,6,2072
Douglas,736S,78.30%,67.50%,65.40%,78.10%,67.60%,66.60%,6353,184,903,283,0,1370,348,1878,1024,0,3250,6353,176,895,275,0,1346,351,1867,981,0,3199
Douglas,737,80.00%,74.90%,67.90%,79.90%,74.80%,71.30%,5177,132,383,160,2,677,280,1143,639,3,2065,5177,116,381,153,1,651,287,1132,610,4,2033
Douglas,738,61.60%,45.00%,43.90%,60.60%,46.00%,43.50%,2253,179,394,178,0,751,140,323,286,0,749,2253,178,379,176,0,733,137,323,271,0,731
Douglas,739,73.50%,64.10%,53.00%,72.60%,63.30%,52.80%,4149,185,619,251,1,1056,209,1104,695,1,2009,4149,184,626,247,1,1058,206,1078,655,1,1940
Douglas,740,69.10%,58.70%,48.20%,67.90%,58.00%,48.90%,2478,115,411,203,0,729,106,583,453,1,1143,2478,113,416,206,0,735,108,575,436,0,1119
Douglas,784,81.30%,74.40%,64.60%,80.60%,74.50%,66.40%,4359,122,478,169,1,770,224,1386,737,0,2347,4359,110,470,169,1,750,219,1376,701,0,2296
Douglas,785,91.90%,84.70%,86.50%,91.80%,85.40%,85.80%,4220,39,287,58,0,384,248,1587,660,1,2496,4220,40,273,57,0,370,241,1591,639,1,2472
Early,A,74.70%,48.60%,47.30%,73.40%,45.10%,47.80%,911,119,127,48,0,294,107,120,142,0,369,911,118,135,49,0,302,108,111,135,0,354
Early,B,66.00%,56.50%,77.50%,63.00%,52.60%,71.70%,3445,122,550,158,3,833,431,714,307,0,1452,3445,148,580,166,3,897,382,644,283,0,1309
Early,CS,48.00%,21.30%,9.60%,44.90%,18.90%,10.50%,1114,263,285,93,0,641,28,77,86,0,191,1114,256,288,92,0,636,30,67,75,0,172
Early,CUBA,69.50%,31.20%,26.00%,69.40%,29.50%,24.30%,1180,179,306,50,0,535,63,139,114,0,316,1180,181,311,49,0,541,58,130,111,0,299
Early,U,34.30%,19.50%,12.80%,30.70%,17.50%,13.00%,670,116,236,67,0,419,17,57,35,0,109,670,114,236,70,0,420,17,50,31,0,98
Echols,1058,20.90%,10.10%,12.70%,20.80%,10.10%,12.30%,2156,226,909,121,0,1256,33,102,32,0,167,2156,221,897,114,0,1232,31,101,30,0,162
Effingham,1A,50.20%,18.10%,13.70%,51.80%,18.10%,15.10%,1965,401,660,106,1,1168,64,146,107,0,317,1965,377,649,95,1,1122,67,143,102,0,312
Effingham,1B,38.00%,13.00%,13.30%,37.90%,13.30%,13.80%,3005,624,941,186,2,1753,96,140,114,0,350,3005,602,919,172,2,1695,97,141,105,0,343
Effingham,1C,46.90%,18.70%,16.20%,48.40%,20.20%,17.30%,1446,413,300,69,0,782,80,69,61,0,210,1446,406,296,64,0,766,85,75,60,0,220
Effingham,1D,39.40%,11.20%,9.30%,39.20%,11.00%,10.00%,2031,545,570,114,1,1230,56,72,74,0,202,2031,538,560,104,1,1203,60,69,67,0,196
Effingham,2A,43.30%,20.60%,16.20%,43.80%,20.00%,14.80%,3038,599,919,204,1,1723,116,238,156,0,510,3038,604,914,194,1,1713,105,228,151,0,484
Effingham,2B,47.30%,24.80%,17.90%,47.40%,24.50%,19.20%,3010,542,787,192,1,1522,116,259,172,2,549,3010,521,783,179,1,1484,123,254,161,1,539
Effingham,2C,51.90%,23.10%,21.30%,56.30%,23.60%,20.80%,4621,637,1491,287,3,2418,172,448,310,1,931,4621,627,1456,248,3,2334,164,449,320,1,934
Effingham,3A,36.70%,15.70%,14.10%,35.60%,15.20%,15.00%,1398,324,428,88,0,840,53,80,51,0,184,1398,311,423,85,0,819,55,76,47,0,178
Effingham,3B,61.60%,28.40%,35.90%,58.00%,27.00%,35.80%,1553,257,394,71,0,722,144,156,114,0,414,1553,257,398,73,0,728,143,147,101,0,391
Effingham,3C,35.20%,22.20%,19.60%,35.90%,22.30%,18.90%,2060,295,699,114,1,1109,71,200,62,1,334,2060,296,688,109,1,1094,68,198,61,1,328
Effingham,3D,53.60%,21.80%,26.60%,53.30%,21.90%,27.70%,3125,442,1019,140,5,1606,161,284,162,1,608,3125,427,1004,135,4,1570,164,281,154,1,600
Effingham,4A,45.40%,20.70%,17.00%,44.40%,20.80%,18.20%,3726,473,1253,207,0,1933,95,327,172,2,596,3726,463,1237,208,0,1908,101,325,166,2,594
Effingham,4B,63.70%,26.30%,24.00%,62.30%,26.80%,25.90%,1888,234,523,90,0,847,74,187,158,0,419,1888,226,513,86,0,825,79,188,142,0,409
Effingham,4C,39.50%,11.30%,13.70%,41.10%,12.20%,15.00%,2837,429,991,182,0,1602,68,126,119,0,313,2837,413,972,175,0,1560,73,135,122,0,330
Effingham,5A,42.20%,18.40%,19.50%,43.80%,18.00%,21.10%,2924,421,955,174,1,1551,100,216,127,2,445,2924,406,945,162,1,1514,107,208,126,2,443
Effingham,5B,57.90%,32.00%,30.90%,56.80%,32.40%,31.90%,3962,475,1036,196,0,1707,211,488,270,1,970,3962,459,1017,194,1,1671,215,488,255,0,958
Effingham,5C,51.00%,27.00%,24.30%,53.50%,27.00%,24.50%,1684,239,505,100,1,845,75,187,104,2,368,1684,234,499,93,0,826,75,185,107,1,368
Elbert,189,59.80%,41.60%,56.60%,59.10%,40.10%,55.70%,3798,172,876,278,0,1326,224,625,414,0,1263,3798,172,883,274,0,1329,216,590,396,0,1202
Elbert,190,46.50%,21.60%,18.60%,40.90%,19.70%,18.60%,622,105,189,53,0,347,24,52,46,0,122,622,105,192,55,0,352,24,47,38,0,109
Elbert,191,47.00%,17.30%,16.60%,43.90%,17.10%,14.40%,748,151,248,70,0,469,30,52,62,0,144,748,154,248,74,0,476,26,51,58,0,135
Elbert,192,40.00%,14.80%,7.60%,36.20%,13.30%,7.70%,377,110,92,45,0,247,9,16,30,0,55,377,108,91,44,0,243,9,14,25,0,48
Elbert,193,47.90%,20.80%,26.80%,44.90%,19.70%,23.70%,1095,131,411,88,0,630,48,108,81,0,237,1095,132,412,92,0,636,41,101,75,0,217
Elbert,196,50.60%,15.30%,14.90%,49.40%,13.80%,15.10%,468,103,127,41,0,271,18,23,42,0,83,468,101,125,41,0,267,18,20,40,0,78
Elbert,197,64.10%,30.10%,18.50%,62.90%,31.10%,17.40%,1596,229,407,120,0,756,52,175,214,0,441,1596,228,394,119,0,741,48,178,202,0,428
Elbert,199,27.80%,15.00%,5.50%,27.30%,15.10%,5.40%,570,189,125,57,0,371,11,22,22,0,55,570,192,124,56,0,372,11,22,21,0,54
Elbert,201,43.10%,15.40%,16.30%,40.40%,14.30%,16.90%,1612,350,493,119,0,962,68,90,90,0,248,1612,344,492,118,0,954,70,82,80,0,232
Elbert,202,43.50%,23.20%,14.00%,37.50%,24.20%,11.20%,408,92,116,35,0,243,15,35,27,0,77,408,95,116,40,0,251,12,37,24,0,73
Elbert,315,41.90%,17.80%,12.80%,37.90%,17.60%,10.90%,1011,205,324,75,0,604,30,70,54,0,154,1011,205,322,77,0,604,25,69,47,0,141
Emanuel,50,21.20%,6.90%,4.30%,19.20%,8.30%,5.50%,686,266,149,41,0,456,12,11,11,0,34,686,260,144,42,0,446,15,13,10,0,38
Emanuel,52,88.20%,37.00%,71.30%,90.00%,37.00%,70.20%,241,27,34,4,0,65,67,20,30,0,117,241,28,34,3,0,65,66,20,27,0,113
Emanuel,53,51.50%,33.50%,40.30%,49.50%,32.00%,39.10%,6988,619,1682,488,1,2790,419,849,518,0,1786,6988,620,1692,479,1,2792,398,798,470,0,1666
Emanuel,57,53.10%,17.20%,16.60%,47.50%,18.40%,14.70%,504,151,106,30,0,287,30,22,34,0,86,504,151,102,32,0,285,26,23,29,0,78
Emanuel,58,41.70%,31.30%,30.60%,40.00%,31.10%,33.00%,608,143,99,28,0,270,63,45,20,0,128,608,132,93,27,0,252,65,42,18,0,125
Emanuel,1208,9.90%,6.30%,2.10%,8.60%,6.30%,3.00%,756,232,253,64,0,549,5,17,7,0,29,756,229,251,64,0,544,7,17,6,0,30
Emanuel,1333,43.90%,26.40%,11.20%,41.50%,25.30%,11.50%,681,239,128,32,0,399,30,46,25,0,101,681,239,127,31,0,397,31,43,22,0,96
Emanuel,1429,53.30%,24.50%,12.70%,47.80%,24.20%,12.90%,489,199,74,21,0,294,29,24,24,0,77,489,195,75,24,0,294,29,24,22,0,75
Emanuel,1502,28.60%,19.60%,16.80%,25.90%,18.80%,15.60%,384,124,78,20,0,222,25,19,8,0,52,384,124,78,20,0,222,23,18,7,0,48
Emanuel,1560,58.30%,30.20%,31.70%,56.30%,30.20%,29.90%,1551,289,363,78,0,730,134,157,109,0,400,1551,298,359,80,0,737,127,155,103,0,385
Emanuel,1748,19.60%,13.00%,10.50%,12.60%,14.40%,10.30%,827,239,160,90,0,489,28,24,22,0,74,827,234,155,90,0,479,27,26,13,0,66
Evans,11,41.40%,27.80%,33.40%,38.30%,27.20%,32.90%,6135,471,1926,491,0,2888,236,741,347,0,1324,6135,463,1922,491,0,2876,227,719,305,0,1251
Fannin,COLW,37.70%,12.50%,9.60%,36.90%,13.60%,8.70%,1105,284,300,127,0,711,30,43,77,0,150,1105,285,298,125,0,708,27,47,73,0,147
Fannin,FAIR,38.90%,18.00%,9.20%,37.70%,17.90%,10.50%,1262,307,309,110,0,726,31,68,70,0,169,1262,299,307,109,0,715,35,67,66,0,168
Fannin,FLIN,28.40%,10.30%,9.20%,27.30%,10.30%,9.80%,3202,661,811,350,2,1824,67,93,139,0,299,3202,641,794,339,2,1776,70,91,127,0,288
Fannin,HEMP,41.50%,17.00%,8.60%,41.80%,16.60%,7.70%,1336,346,328,114,3,791,33,67,81,0,181,1336,343,326,106,3,778,29,65,76,0,170
Fannin,HOTH,38.40%,15.60%,5.10%,37.70%,14.50%,5.50%,1290,272,367,138,7,784,15,68,86,0,169,1290,266,366,129,7,768,16,62,78,0,156
Fannin,MINE,31.70%,12.60%,5.60%,30.70%,12.00%,7.60%,1817,351,589,228,0,1168,21,85,106,0,212,1817,342,580,224,0,1146,28,79,99,0,206
Fannin,MOBI,23.70%,16.80%,8.30%,22.70%,15.40%,9.50%,1160,309,267,135,0,711,28,54,42,0,124,1160,297,264,136,0,697,31,48,40,0,119
Fannin,MORG,31.90%,16.70%,8.70%,29.40%,15.80%,9.60%,2067,461,569,233,2,1265,44,114,109,0,267,2067,450,569,233,2,1254,48,107,97,0,252
Fannin,NOON,34.20%,17.90%,12.10%,33.70%,17.20%,10.40%,839,174,225,125,0,524,24,49,65,0,138,839,173,226,120,0,519,20,47,61,0,128
Fannin,SKEN,39.40%,24.70%,11.00%,35.90%,26.00%,7.50%,331,110,58,40,3,211,14,19,26,0,59,331,110,54,41,1,206,9,19,23,0,51
Fannin,SUGC,36.00%,16.30%,6.90%,33.50%,15.20%,6.50%,2437,392,792,265,1,1450,29,154,149,0,332,2437,387,797,264,0,1448,27,143,133,0,303
Fannin,TOCC,35.00%,16.10%,8.70%,32.50%,15.60%,8.20%,3553,496,1115,388,5,2004,48,214,209,0,471,3553,477,1097,378,5,1957,43,202,182,0,427
Fayette,1,70.60%,73.40%,63.40%,69.70%,73.40%,63.10%,2699,82,307,204,5,598,146,849,490,5,1490,2699,80,303,203,6,592,143,837,467,4,1451
Fayette,2,37.00%,11.80%,7.70%,33.60%,11.40%,7.40%,2567,529,976,286,2,1793,44,131,168,0,343,2567,526,972,290,1,1789,42,125,147,0,314
Fayette,3,89.90%,87.20%,78.90%,90.10%,87.00%,80.10%,3310,53,180,87,3,323,197,1224,778,12,2211,3310,50,180,83,3,316,200,1208,757,13,2178
Fayette,4,64.80%,60.80%,58.30%,61.50%,59.60%,59.60%,2147,75,333,157,3,568,104,517,289,5,915,2147,71,338,167,3,579,105,499,267,4,875
Fayette,5,66.00%,56.00%,44.20%,65.90%,56.30%,46.70%,2362,120,446,166,0,732,94,567,322,1,984,2362,113,435,158,0,706,98,560,306,1,965
Fayette,6,66.40%,68.50%,40.50%,65.50%,69.20%,42.70%,1732,128,231,119,0,478,87,503,235,0,825,1732,125,222,118,0,465,93,499,224,0,816
Fayette,7,77.80%,59.50%,50.80%,77.80%,59.60%,52.30%,2309,150,373,105,0,628,154,547,368,1,1070,2309,142,366,102,0,610,155,539,358,1,1053
Fayette,8,64.70%,59.00%,55.90%,63.00%,59.10%,56.50%,3059,114,524,281,1,920,145,754,515,1,1415,3059,113,520,291,1,925,147,752,495,1,1395
Fayette,9,50.30%,32.20%,29.90%,45.20%,30.20%,25.70%,3045,140,1187,198,3,1528,61,563,200,0,824,3045,148,1205,204,2,1559,52,522,168,0,742
Fayette,10,71.80%,60.90%,53.60%,69.40%,60.70%,56.40%,4848,146,957,232,3,1338,169,1490,590,3,2252,4848,136,953,238,3,1330,177,1470,541,3,2191
Fayette,11,55.10%,34.50%,28.30%,52.40%,33.80%,27.50%,1689,179,471,124,1,775,70,248,152,1,471,1689,181,473,128,1,783,68,242,141,1,452
Fayette,12,58.70%,32.40%,33.30%,53.30%,28.90%,30.60%,1236,49,465,119,1,634,24,223,169,1,417,1236,49,480,128,1,658,21,195,146,1,363
Fayette,13,41.30%,20.90%,19.80%,38.40%,19.40%,19.90%,3572,377,1138,370,0,1885,93,300,260,0,653,3572,378,1152,371,0,1901,94,278,231,0,603
Fayette,14,49.60%,30.30%,25.90%,44.80%,28.30%,25.30%,3564,285,1253,357,4,1899,94,545,351,7,997,3564,291,1284,382,2,1959,91,507,310,8,916
Fayette,15,39.40%,18.10%,14.10%,36.80%,17.30%,12.90%,2542,324,920,339,0,1583,53,203,220,0,476,2542,323,916,344,0,1583,48,191,200,0,439
Fayette,16,53.80%,33.70%,27.80%,50.50%,30.20%,22.20%,3323,189,1116,314,1,1620,72,568,366,1,1007,3323,202,1173,322,1,1698,57,507,329,1,894
Fayette,17,55.00%,35.60%,33.00%,53.30%,32.30%,31.90%,1344,128,413,99,0,640,61,228,121,2,412,1344,126,430,98,0,654,58,205,112,1,376
Fayette,18,62.90%,41.90%,38.20%,60.40%,40.50%,39.30%,4862,319,1332,339,1,1991,195,959,574,3,1731,4862,311,1349,344,1,2005,199,919,525,3,1646
Fayette,19,46.20%,33.10%,29.80%,44.30%,30.60%,24.30%,1805,127,598,161,0,886,54,296,138,0,488,1805,134,616,161,0,911,43,271,128,0,442
Fayette,20,57.30%,34.70%,19.00%,55.60%,32.80%,20.70%,1011,117,313,64,2,496,28,166,86,0,280,1011,117,319,64,2,502,31,156,80,0,267
Fayette,21,47.10%,38.90%,41.10%,42.20%,38.10%,40.20%,2117,150,519,208,2,879,104,330,185,2,621,2117,150,523,218,2,893,101,322,159,1,583
Fayette,22,42.80%,21.10%,21.50%,35.70%,19.30%,17.20%,1876,171,759,183,1,1114,47,203,137,0,387,1876,181,767,196,2,1146,38,184,109,0,331
Fayette,23,86.20%,81.30%,66.40%,82.20%,82.30%,68.30%,1014,48,72,35,0,155,93,312,218,2,625,1014,46,68,44,0,158,97,316,203,2,618
Fayette,24,57.40%,53.20%,45.70%,55.40%,53.80%,44.80%,1624,126,271,170,0,567,106,308,229,0,643,1624,123,262,172,0,557,100,305,214,0,619
Fayette,25,48.30%,34.30%,29.50%,44.20%,32.80%,27.40%,1646,146,476,179,2,803,61,249,167,1,478,1646,152,480,187,2,821,58,234,148,0,440
Fayette,26,65.50%,46.90%,35.20%,63.10%,46.00%,35.10%,3100,209,723,229,5,1166,113,638,434,3,1188,3100,206,726,235,7,1174,113,618,401,2,1134
Fayette,27,52.90%,35.80%,27.30%,48.70%,34.50%,28.40%,3092,223,1003,290,3,1519,85,559,326,0,970,3092,216,1022,312,3,1553,87,538,296,0,921
Fayette,28,69.80%,60.00%,49.00%,68.00%,60.00%,49.00%,2225,129,336,176,2,643,120,505,407,6,1038,2225,130,334,182,2,648,121,502,387,6,1016
Fayette,29,69.10%,65.60%,60.80%,67.10%,65.30%,63.90%,2876,78,397,185,4,664,120,758,414,7,1299,2876,69,395,189,4,657,123,743,385,6,1257
Fayette,30,60.20%,49.70%,41.70%,56.30%,49.00%,40.00%,3224,151,735,299,4,1189,110,727,452,1,1290,3224,153,739,320,3,1215,103,711,413,1,1228
Fayette,31,61.90%,34.10%,30.00%,58.40%,32.20%,27.40%,3497,252,1189,236,0,1677,108,614,383,0,1105,3497,255,1218,254,0,1727,96,579,357,0,1032
Fayette,32,52.90%,32.40%,29.80%,48.40%,31.00%,30.50%,2007,144,669,154,0,967,61,320,173,0,554,2007,139,674,159,0,972,61,303,149,0,513
Fayette,33,51.10%,28.30%,19.50%,46.90%,27.20%,21.60%,1895,164,686,170,1,1021,39,271,178,1,489,1895,155,688,179,1,1023,42,257,158,1,458
Fayette,34,50.40%,28.10%,20.50%,46.30%,26.10%,19.50%,3833,359,1624,336,1,2320,91,634,341,2,1068,3833,362,1659,353,1,2375,87,586,304,1,978
Fayette,35,67.60%,54.40%,43.00%,66.00%,53.40%,43.60%,3299,127,712,244,0,1083,94,849,508,2,1453,3299,127,721,245,0,1093,96,827,475,2,1400
Fayette,36,55.50%,38.40%,29.60%,54.40%,38.00%,28.20%,1956,244,458,167,1,870,103,285,208,0,596,1956,251,450,164,1,866,99,276,196,0,571
Floyd,1,46.60%,22.30%,22.90%,43.20%,20.90%,21.20%,3360,327,1137,290,10,1764,95,326,253,5,679,3360,321,1137,294,9,1761,88,300,224,1,613
Floyd,10,29.90%,15.90%,10.70%,26.20%,16.50%,10.90%,1269,283,398,108,2,791,34,75,46,0,155,1269,277,389,107,2,775,34,77,38,0,149
Floyd,15,29.70%,9.70%,8.70%,31.30%,10.40%,9.40%,2355,393,948,196,6,1543,38,102,83,0,223,2355,390,930,178,6,1504,41,108,81,0,230
Floyd,20,47.10%,16.40%,13.30%,44.90%,16.00%,14.40%,1617,423,332,126,2,883,63,65,112,2,242,1617,409,326,125,2,862,67,62,102,2,233
Floyd,25,38.70%,11.50%,11.10%,37.20%,12.80%,10.70%,1155,277,338,95,11,721,36,44,60,0,140,1155,274,333,91,9,707,33,49,54,1,137
Floyd,30,40.50%,17.50%,13.20%,41.20%,17.30%,15.00%,4946,599,1925,433,7,2964,89,408,295,3,795,4946,579,1914,414,6,2913,100,400,290,3,793
Floyd,35,43.50%,10.80%,12.60%,47.60%,11.10%,11.80%,421,175,74,26,5,280,26,9,20,0,55,421,175,72,22,5,274,24,9,20,0,53
Floyd,40,23.90%,11.10%,6.90%,24.90%,10.10%,7.40%,1666,408,582,143,21,1154,28,73,45,4,150,1666,406,585,139,19,1149,30,66,46,4,146
Floyd,45,32.00%,11.00%,5.40%,32.60%,10.80%,6.80%,971,278,284,68,1,631,16,35,32,0,83,971,272,280,62,1,615,20,34,30,0,84
Floyd,50,40.10%,27.60%,28.40%,39.30%,28.30%,29.80%,2261,215,622,188,4,1029,84,237,126,3,450,2261,203,603,185,4,995,86,238,120,2,446
Floyd,55,44.20%,19.60%,16.80%,43.30%,19.30%,18.00%,3635,522,1045,254,2,1823,104,255,201,2,562,3635,503,1033,242,2,1780,109,247,185,2,543
Floyd,60,20.10%,12.90%,5.90%,18.60%,12.80%,6.60%,1492,427,420,123,1,971,27,62,31,0,120,1492,425,410,118,1,954,30,60,27,0,117
Floyd,65,40.50%,21.00%,17.40%,39.60%,20.10%,18.10%,3398,437,1098,266,0,1801,90,292,181,2,565,3398,427,1098,259,2,1786,95,276,170,0,541
Floyd,75,59.10%,39.70%,53.00%,56.10%,38.40%,53.00%,5096,234,1157,307,6,1704,259,762,443,12,1476,5096,225,1165,312,5,1707,247,725,398,12,1382
Floyd,76,56.10%,38.70%,45.20%,55.40%,36.90%,45.50%,3923,298,876,246,6,1426,247,553,314,4,1118,3923,294,891,239,5,1429,246,521,297,4,1068
Floyd,80,32.50%,16.20%,13.20%,32.40%,16.10%,13.60%,1865,274,568,133,2,977,40,110,64,2,216,1865,265,551,123,1,940,39,106,59,3,207
Floyd,85,39.20%,26.20%,22.10%,38.70%,26.50%,23.10%,826,148,208,45,4,405,43,74,29,0,146,826,146,205,46,4,401,45,74,29,0,148
Floyd,90,61.30%,47.30%,40.50%,58.70%,45.60%,40.80%,4238,267,785,249,2,1303,181,705,394,2,1282,4238,265,805,253,2,1325,182,675,360,2,1219
Floyd,105,59.00%,41.40%,52.40%,57.60%,40.40%,53.90%,3369,145,654,287,2,1088,157,462,413,5,1037,3369,138,653,285,2,1078,159,442,387,5,993
Floyd,110,84.00%,69.70%,77.20%,81.20%,68.80%,75.00%,1600,45,118,40,1,204,152,272,210,4,638,1600,46,119,43,1,209,139,262,186,2,589
Floyd,115,36.60%,12.60%,7.60%,34.40%,12.10%,5.20%,762,258,216,59,8,541,22,31,34,0,87,762,263,217,59,8,547,15,30,31,0,76
Floyd,125,21.10%,21.10%,16.90%,18.40%,20.90%,18.50%,896,149,198,86,3,436,31,53,23,0,107,896,139,197,84,2,422,32,52,19,0,103
Floyd,130,31.70%,13.20%,11.40%,30.40%,13.40%,11.40%,3566,654,1198,280,6,2138,79,182,130,6,397,3566,642,1175,265,6,2088,77,182,116,6,381
Floyd,135,40.80%,18.20%,14.30%,40.30%,18.20%,17.10%,2929,491,821,199,0,1511,82,183,137,0,402,2929,460,811,190,0,1461,95,180,128,0,403
Floyd,140,61.30%,40.00%,43.90%,57.00%,38.10%,42.40%,3034,170,676,189,0,1035,131,450,300,2,883,3034,174,691,205,0,1070,126,426,272,2,826
Forsyth,1,58.40%,37.30%,32.10%,55.60%,36.30%,32.00%,11222,535,3433,1124,3,5095,252,2041,1576,2,3871,11222,523,3459,1162,3,5147,245,1967,1453,2,3667
Forsyth,2,70.80%,51.60%,46.90%,69.40%,50.90%,45.30%,4500,321,802,280,1,1404,283,856,680,1,1820,4500,324,808,282,1,1415,268,838,640,1,1747
Forsyth,3,37.00%,19.60%,18.60%,34.00%,18.90%,19.60%,10740,779,4258,1084,2,6123,174,1036,636,4,1850,10740,751,4238,1070,2,6061,180,985,551,4,1720
Forsyth,4,35.90%,13.50%,13.30%,33.10%,13.20%,13.10%,6776,583,2971,598,2,4154,90,464,335,0,889,6776,570,2971,605,1,4147,85,450,300,1,836
Forsyth,5,45.50%,22.60%,22.30%,42.70%,21.50%,22.90%,7852,593,3173,579,1,4346,169,924,483,1,1577,7852,571,3177,583,1,4332,169,872,434,1,1476
Forsyth,6,40.10%,18.20%,15.50%,38.60%,17.50%,16.00%,7061,513,2984,483,1,3981,94,665,323,0,1082,7061,497,2961,473,1,3932,95,626,297,0,1018
Forsyth,7,46.50%,24.60%,32.60%,44.80%,24.00%,31.90%,6281,315,2105,568,1,2989,152,685,494,1,1332,6281,309,2082,550,1,2942,144,657,446,1,1248
Forsyth,8,46.50%,24.30%,22.40%,42.40%,22.70%,21.40%,8296,576,3178,878,1,4633,166,1019,763,1,1949,8296,571,3221,908,1,4701,155,944,669,1,1769
Forsyth,10,53.50%,27.10%,26.40%,49.10%,25.20%,25.70%,11631,578,4799,999,5,6381,209,1783,1149,0,3141,11631,576,4870,1059,5,6510,201,1638,1021,0,2860
Forsyth,15,43.30%,18.70%,21.00%,40.90%,18.10%,20.30%,8091,603,3499,699,0,4801,160,805,534,0,1499,8091,593,3477,699,0,4769,151,767,483,0,1401
Forsyth,16,38.90%,22.60%,22.60%,35.20%,21.50%,19.90%,6333,409,2404,704,3,3520,120,701,449,0,1270,6333,407,2412,713,3,3535,102,659,388,0,1149
Forsyth,19,58.30%,33.40%,31.00%,53.60%,31.50%,29.20%,3739,178,1332,301,0,1811,80,669,420,0,1169,3739,182,1360,320,0,1862,75,626,369,0,1070
Forsyth,21,51.30%,27.60%,28.50%,47.30%,25.90%,26.30%,8318,294,3244,894,2,4434,117,1238,941,1,2297,8318,302,3300,930,1,4533,106,1155,834,2,2097
Forsyth,25,59.90%,35.80%,32.80%,55.10%,34.60%,32.00%,9714,480,3368,750,1,4599,234,1879,1119,1,3233,9714,478,3399,811,1,4689,223,1800,996,2,3021
Forsyth,27,42.80%,19.10%,16.60%,39.40%,17.80%,16.30%,9858,861,4347,728,3,5939,172,1024,545,0,1741,9858,847,4363,742,3,5955,166,945,482,0,1593
Forsyth,29,55.40%,30.80%,29.40%,51.50%,29.40%,29.50%,11222,663,3673,1104,1,5441,277,1632,1372,0,3281,11222,652,3694,1152,0,5498,273,1535,1221,0,3029
Forsyth,34,60.30%,37.10%,30.30%,58.20%,36.40%,32.10%,4965,322,1491,414,0,2227,139,878,630,1,1648,4965,307,1489,420,0,2216,144,854,585,1,1584
Forsyth,35,61.80%,40.50%,38.50%,58.30%,38.70%,38.00%,8444,268,2453,818,0,3539,167,1673,1326,1,3167,8444,259,2505,864,0,3628,158,1582,1207,1,2948
Forsyth,36,58.40%,37.30%,31.80%,54.60%,34.90%,29.90%,6989,317,2425,563,1,3306,145,1441,790,3,2379,6989,329,2485,593,1,3408,139,1334,713,2,2188
Forsyth,37,51.70%,26.30%,24.40%,49.10%,25.30%,23.80%,11952,552,4800,1044,3,6399,175,1712,1117,4,3008,11952,539,4776,1054,3,6372,165,1621,1018,4,2808
Franklin,1,24.70%,7.90%,9.70%,25.70%,7.00%,9.50%,2382,260,1090,220,0,1570,28,93,72,0,193,2382,258,1092,214,0,1564,27,82,74,0,183
Franklin,2,23.20%,7.50%,9.40%,20.00%,7.50%,9.30%,1764,319,571,162,0,1052,33,46,49,0,128,1764,312,570,160,0,1042,32,46,40,0,118
Franklin,3,33.00%,11.00%,10.70%,30.00%,10.50%,10.30%,2935,448,1000,300,2,1750,54,123,148,0,325,2935,442,991,298,0,1731,49,116,128,2,295
Franklin,4,41.90%,16.80%,26.40%,38.10%,15.10%,23.70%,2355,293,726,180,0,1199,105,147,130,0,382,2355,296,730,185,0,1211,92,130,114,0,336
Franklin,5,22.90%,9.80%,10.30%,22.40%,10.30%,11.50%,1244,288,406,111,0,805,33,44,33,0,110,1244,277,399,104,0,780,36,46,30,0,112
Franklin,6,31.80%,15.20%,19.30%,29.80%,14.50%,18.30%,2034,288,625,217,0,1130,69,112,101,0,282,2034,282,626,212,0,1120,63,106,90,0,259
Franklin,7,23.30%,8.00%,6.10%,22.80%,7.60%,5.60%,2432,403,946,214,0,1563,26,82,65,0,173,2432,402,937,206,0,1545,24,77,61,0,162
Fulton,01A,92.90%,92.00%,79.60%,91.40%,91.40%,78.00%,3694,41,145,56,5,247,160,1662,737,20,2579,3694,45,154,67,5,271,157,1638,709,20,2524
Fulton,01B,93.50%,92.10%,75.50%,91.80%,91.10%,75.80%,4327,79,159,62,1,301,242,1842,895,5,2984,4327,75,177,76,1,329,233,1811,854,5,2903
Fulton,01C,95.40%,94.90%,89.60%,96.30%,95.60%,89.70%,1908,21,20,8,0,49,180,372,165,0,717,1908,20,17,6,0,43,175,368,156,0,699
Fulton,01D,90.40%,95.60%,77.80%,90.10%,93.90%,75.70%,754,7,13,13,1,34,24,284,123,4,435,754,8,18,13,1,40,22,276,118,6,422
Fulton,01E,90.70%,90.30%,71.10%,89.00%,89.00%,73.60%,3720,40,167,79,1,287,101,1559,775,0,2435,3720,36,189,91,1,317,103,1528,738,0,2369
Fulton,01F,94.70%,95.20%,88.60%,95.20%,95.10%,96.10%,1593,14,13,6,1,34,110,256,108,7,481,1593,4,13,5,1,23,119,254,100,5,478
Fulton,01G,95.20%,93.00%,88.70%,94.60%,93.20%,89.80%,2312,15,55,15,2,87,131,730,295,3,1159,2312,14,53,16,1,84,129,724,280,3,1136
Fulton,01H,97.60%,96.80%,92.20%,93.40%,96.70%,95.80%,896,6,7,3,0,16,64,212,122,7,405,896,3,7,8,0,18,62,206,113,6,387
Fulton,01J,96.50%,94.50%,92.90%,95.40%,94.10%,90.50%,2848,17,42,12,1,72,217,720,333,17,1287,2848,22,44,15,2,83,214,701,308,15,1238
Fulton,01P,97.70%,96.90%,92.60%,96.40%,97.80%,94.60%,1444,16,7,4,1,28,208,220,171,4,603,1444,10,5,6,2,23,207,222,161,3,593
Fulton,01R,95.90%,94.50%,89.90%,93.40%,94.40%,92.50%,1550,20,8,5,4,37,202,137,117,12,468,1550,15,8,8,2,33,198,135,114,12,459
Fulton,01S,94.50%,95.50%,91.80%,94.30%,95.00%,93.40%,2118,20,23,12,1,56,228,486,207,7,928,2118,17,25,12,0,54,232,473,200,8,913
Fulton,01T,93.30%,94.70%,85.00%,90.10%,94.50%,84.00%,1799,27,26,13,1,67,156,469,180,3,808,1799,29,27,19,1,76,154,465,172,3,794
Fulton,02A,86.50%,80.80%,65.00%,82.30%,78.20%,55.60%,4884,83,410,170,3,666,137,1728,1087,23,2975,4884,103,466,216,7,792,120,1671,1001,18,2810
Fulton,02A1,90.30%,80.20%,64.30%,85.50%,78.00%,55.80%,733,13,67,6,2,88,25,271,56,2,354,733,17,74,8,2,101,22,262,47,2,333
Fulton,02B,90.60%,88.80%,81.70%,91.00%,88.80%,82.20%,4020,36,96,30,6,168,165,764,290,23,1242,4020,35,95,27,7,164,170,750,274,24,1218
Fulton,02C,92.50%,90.20%,76.50%,93.10%,90.30%,73.10%,2034,23,75,31,9,138,75,689,382,29,1175,2034,26,72,27,10,135,70,673,367,28,1138
Fulton,02D,91.70%,86.90%,71.80%,89.40%,84.50%,70.60%,5539,92,283,97,6,478,224,1879,1071,26,3200,5539,89,332,120,12,553,219,1804,1007,23,3053
Fulton,02E,93.30%,92.30%,72.90%,90.60%,90.60%,72.20%,2009,35,74,34,0,143,94,892,477,0,1463,2009,37,90,47,0,174,96,870,455,0,1421
Fulton,02F1,90.90%,88.50%,69.30%,88.60%,86.30%,65.20%,3221,39,163,74,4,280,94,1254,741,3,2092,3221,46,193,89,3,331,88,1216,693,4,2001
Fulton,02F2,92.50%,88.50%,67.20%,90.50%,86.60%,67.20%,851,17,33,11,4,65,41,254,135,2,432,851,17,38,14,3,72,39,246,134,2,421
Fulton,02G,91.00%,89.30%,67.20%,88.60%,86.80%,67.30%,3895,82,193,74,0,349,163,1610,745,5,2523,3895,78,237,91,2,408,162,1555,706,3,2426
Fulton,02J,90.30%,91.50%,73.50%,87.20%,89.40%,73.50%,2273,33,82,46,2,163,86,887,428,11,1412,2273,33,103,61,2,199,87,868,414,10,1379
Fulton,02K,94.30%,86.40%,63.20%,92.20%,86.10%,54.70%,1461,25,92,18,0,135,43,583,298,0,924,1461,29,92,24,0,145,35,569,283,0,887
Fulton,02L1,87.00%,84.10%,63.30%,84.30%,82.30%,62.10%,5546,98,375,190,5,668,167,1989,1273,11,3440,5546,101,416,223,6,746,166,1933,1200,9,3308
Fulton,02L1A,91.40%,87.50%,73.80%,84.50%,86.60%,72.10%,1477,24,79,9,3,115,72,552,96,4,724,1477,27,84,16,2,129,69,542,87,6,704
Fulton,02L2,91.20%,85.60%,70.50%,85.50%,82.90%,69.30%,2249,44,140,36,2,222,105,829,375,5,1314,2249,45,164,58,2,269,102,793,343,4,1242
Fulton,02S,91.70%,94.30%,72.50%,90.40%,94.70%,75.50%,790,14,17,12,0,43,37,281,132,0,450,790,12,16,13,0,41,37,284,122,0,443
Fulton,02W,85.30%,86.00%,68.60%,84.30%,86.60%,68.70%,978,22,61,21,0,104,48,374,122,0,544,978,21,58,22,0,101,46,374,118,0,538
Fulton,03A,96.60%,95.10%,92.60%,96.00%,95.50%,93.50%,2230,10,20,8,3,41,146,387,227,17,777,2230,10,18,9,1,38,137,381,216,21,755
Fulton,03B,90.90%,94.40%,92.90%,91.10%,92.90%,91.20%,777,4,6,6,0,16,52,101,60,0,213,777,5,7,5,0,17,52,92,51,0,195
Fulton,03C,96.20%,97.50%,94.50%,95.60%,98.00%,93.80%,1879,8,9,9,1,27,147,344,230,7,728,1879,10,7,10,0,27,145,337,216,6,704
Fulton,03D,92.10%,95.70%,91.40%,91.70%,96.40%,89.00%,1235,9,10,9,1,29,85,222,105,21,433,1235,11,8,9,1,29,77,215,99,20,411
Fulton,03E,96.10%,95.50%,89.20%,97.60%,95.20%,92.90%,2894,33,23,9,6,71,282,483,219,40,1024,2894,20,24,5,5,54,289,477,205,36,1007
Fulton,03F,89.50%,83.40%,72.00%,87.90%,82.40%,70.90%,2328,44,155,42,1,242,113,779,358,3,1253,2328,45,161,47,1,254,109,754,342,3,1208
Fulton,03G,95.60%,96.10%,93.20%,95.30%,97.30%,94.10%,1033,6,6,2,0,14,77,147,43,5,272,1033,5,4,2,0,11,76,146,41,4,267
Fulton,03H,96.00%,93.40%,84.80%,97.80%,96.80%,90.10%,1091,14,15,4,0,33,77,213,97,1,388,1091,9,7,2,0,18,81,212,91,1,385
Fulton,03I,89.80%,88.30%,77.80%,87.30%,83.90%,84.10%,1607,25,44,13,7,89,95,332,115,17,559,1607,17,61,16,5,99,96,319,110,20,545
Fulton,03L,93.30%,97.00%,86.80%,92.70%,96.00%,93.30%,748,10,3,3,0,16,66,98,42,0,206,748,5,4,3,0,12,70,96,38,0,204
Fulton,03M,94.50%,87.50%,73.30%,96.60%,84.10%,69.40%,965,50,33,5,0,88,135,232,86,2,455,965,56,42,3,0,101,126,222,86,1,435
Fulton,03N,96.40%,95.10%,93.30%,95.60%,95.00%,93.40%,2804,16,24,6,2,48,228,461,160,21,870,2804,14,24,7,3,48,221,454,152,21,848
Fulton,03P1A,89.60%,88.80%,74.70%,87.80%,87.50%,78.00%,4404,79,170,62,2,313,224,1346,533,15,2118,4404,67,189,70,2,328,232,1317,502,13,2064
Fulton,03P2,0.00%,100.00%,0.00%,0.00%,100.00%,0.00%,23,0,0,0,0,0,0,7,0,0,7,23,0,0,0,0,0,0,7,0,0,7
Fulton,03S,95.40%,98.10%,89.50%,95.40%,98.60%,95.00%,908,11,4,5,0,20,94,210,104,0,408,908,5,3,5,0,13,95,204,103,0,402
Fulton,03T,95.70%,95.40%,91.40%,96.90%,95.10%,90.60%,1742,14,24,6,0,44,142,501,132,6,781,1742,15,25,4,0,44,139,485,126,5,755
Fulton,04A,97.00%,96.60%,96.20%,96.30%,96.60%,95.20%,1554,4,11,5,0,20,100,317,163,0,580,1554,5,11,6,0,22,99,315,158,0,572
Fulton,04B,96.90%,96.10%,92.90%,96.70%,96.30%,91.30%,2948,9,17,7,0,33,117,419,222,0,758,2948,11,16,7,0,34,115,414,207,0,736
Fulton,04C,100.00%,100.00%,91.70%,100.00%,100.00%,100.00%,150,1,0,0,0,1,10,28,12,1,51,150,0,0,0,0,0,11,28,12,1,52
Fulton,04D,98.10%,96.20%,93.50%,95.90%,94.80%,93.40%,1736,11,18,4,0,33,153,452,202,5,812,1736,11,24,8,0,43,150,440,188,5,783
Fulton,04F,94.00%,91.60%,85.20%,92.20%,91.30%,85.00%,2786,31,69,13,1,114,175,756,205,9,1145,2786,31,71,16,1,119,172,742,190,9,1113
Fulton,04G,94.00%,97.50%,92.60%,97.50%,96.90%,98.30%,1025,8,5,5,1,19,113,196,79,0,388,1025,2,6,2,0,10,114,188,78,1,381
Fulton,04I,91.40%,92.90%,85.10%,91.40%,92.90%,82.60%,4604,13,35,22,1,71,74,455,234,6,769,4604,16,34,21,0,71,71,447,222,5,745
Fulton,04J,90.50%,98.20%,91.70%,88.20%,96.40%,92.70%,1617,5,2,2,0,9,43,109,19,12,183,1617,3,4,2,1,10,42,108,15,9,174
Fulton,04K,95.70%,96.40%,89.10%,97.10%,96.70%,94.90%,2736,22,27,16,2,67,184,717,359,13,1273,2736,11,24,10,0,45,192,711,338,13,1254
Fulton,04L,93.10%,96.30%,87.40%,92.70%,96.80%,91.00%,2014,23,22,15,0,60,154,568,201,6,929,2014,16,18,15,0,49,155,551,190,6,902
Fulton,04M,93.20%,96.30%,96.40%,95.70%,96.70%,95.50%,979,4,6,5,0,15,101,154,68,5,328,979,5,5,3,0,13,101,145,66,4,316
Fulton,04S,96.90%,97.50%,92.40%,96.10%,96.60%,91.90%,2541,20,16,10,2,48,262,620,310,6,1198,2541,22,21,12,1,56,256,605,293,6,1160
Fulton,04T,97.00%,94.10%,91.30%,98.10%,95.70%,96.80%,1297,11,21,5,3,40,128,335,161,19,643,1297,4,15,3,1,23,130,337,157,21,645
Fulton,04V,96.00%,97.10%,90.30%,95.70%,97.30%,94.50%,3573,37,21,10,1,69,349,699,237,3,1288,3573,20,19,10,1,50,357,685,222,2,1266
Fulton,04W,96.60%,100.00%,98.40%,96.40%,99.20%,98.40%,3365,0,0,1,1,2,57,134,28,6,225,3365,0,1,1,1,3,57,131,27,6,221
Fulton,04X1,96.10%,95.30%,88.60%,96.00%,95.20%,92.30%,2283,20,30,11,0,61,153,607,273,2,1035,2283,13,30,11,0,54,153,595,265,2,1015
Fulton,04X2,98.00%,92.30%,85.50%,96.90%,93.40%,93.50%,846,9,19,2,0,30,53,227,100,0,380,846,4,16,3,0,23,58,228,95,0,381
Fulton,05A1,94.30%,90.90%,69.70%,92.80%,89.80%,71.60%,2936,46,124,38,0,208,104,1239,628,2,1973,2936,42,139,47,0,228,104,1223,609,2,1938
Fulton,05A2,93.40%,91.40%,77.40%,92.10%,90.10%,76.10%,3343,37,133,44,3,217,127,1421,627,10,2185,3343,38,154,51,4,247,126,1396,593,8,2123
Fulton,05B,94.40%,95.80%,86.80%,93.20%,94.70%,91.80%,2171,24,27,16,1,68,163,621,269,2,1055,2171,14,34,18,1,67,167,605,248,2,1022
Fulton,05C,88.90%,89.70%,80.00%,77.80%,89.70%,100.00%,135,1,3,1,0,5,4,26,8,0,38,135,0,3,2,0,5,7,26,7,0,40
Fulton,05D,100.00%,96.60%,84.00%,87.50%,98.30%,92.00%,541,4,2,0,0,6,19,56,8,2,85,541,2,1,1,0,4,21,58,7,2,88
Fulton,05F,100.00%,92.40%,76.90%,95.70%,91.10%,87.00%,248,5,7,0,1,13,20,85,25,0,130,248,3,8,1,0,12,19,82,22,1,124
Fulton,05J,91.30%,90.70%,79.10%,88.10%,91.00%,82.60%,684,9,27,12,0,48,33,262,126,1,422,684,8,26,16,0,50,37,263,119,1,420
Fulton,05K,91.70%,91.10%,83.60%,91.70%,91.10%,85.30%,2826,25,68,24,2,119,135,694,265,3,1097,2826,22,66,23,2,113,136,678,255,3,1072
Fulton,06B,90.60%,85.40%,56.90%,87.50%,82.20%,50.00%,1889,51,129,42,2,224,65,757,404,5,1231,1889,58,158,54,2,272,54,729,379,6,1168
Fulton,06D,86.70%,81.40%,72.20%,82.40%,78.60%,68.90%,6160,109,472,314,2,897,273,2061,2048,15,4397,6160,121,540,408,4,1073,265,1981,1916,12,4174
Fulton,06D1,79.40%,82.50%,51.80%,73.70%,78.40%,47.20%,2539,52,202,43,2,299,55,954,166,3,1178,2539,56,250,55,1,362,48,910,154,3,1115
Fulton,06D2,81.50%,79.50%,50.00%,73.00%,74.90%,42.40%,850,16,80,12,0,108,16,311,53,0,380,850,18,99,17,1,135,14,295,46,0,355
Fulton,06E,87.30%,84.20%,64.50%,82.00%,80.90%,59.70%,2344,50,153,61,5,269,98,818,419,2,1337,2344,58,184,83,4,329,90,778,378,2,1248
Fulton,06F,90.60%,84.20%,69.70%,85.40%,81.00%,63.80%,2841,41,206,54,5,306,103,1100,520,3,1726,2841,50,245,83,4,382,92,1043,486,3,1624
Fulton,06G,90.40%,84.40%,55.60%,85.20%,81.90%,40.00%,588,12,40,13,0,65,14,217,123,1,355,588,14,46,20,1,81,10,208,115,0,333
Fulton,06I,91.10%,88.40%,72.30%,90.00%,86.90%,72.10%,4072,92,177,53,7,329,243,1344,540,15,2142,4072,93,199,57,6,355,242,1318,513,14,2087
Fulton,06J,90.20%,84.00%,61.30%,85.70%,80.20%,50.00%,2770,46,198,85,0,329,73,1036,785,0,1894,2770,59,242,121,1,423,60,982,723,0,1765
Fulton,06L1,84.70%,79.20%,55.60%,78.90%,72.50%,47.40%,991,24,96,42,0,162,27,366,232,3,628,991,30,127,58,0,215,25,334,217,2,578
Fulton,06L2,82.80%,71.20%,39.60%,74.40%,66.70%,34.00%,726,29,100,30,0,159,18,247,144,1,410,726,33,115,44,0,192,16,230,128,1,375
Fulton,06N,80.70%,66.70%,55.00%,68.40%,60.70%,50.80%,1770,54,224,69,4,351,63,448,289,8,808,1770,60,266,113,4,443,58,411,245,8,722
Fulton,06Q,92.60%,96.30%,85.00%,93.80%,96.80%,79.30%,571,7,8,5,2,22,47,210,63,4,324,571,9,7,4,3,23,44,209,60,2,315
Fulton,06R,85.60%,80.60%,56.80%,80.60%,76.50%,53.30%,2015,34,157,66,4,261,50,651,391,0,1092,2015,40,188,86,2,316,47,611,358,1,1017
Fulton,07A,73.30%,59.30%,49.00%,68.10%,55.30%,46.70%,7691,334,1262,426,8,2030,312,1842,1170,17,3341,7691,347,1377,494,8,2226,298,1706,1053,13,3070
Fulton,07B,63.50%,41.60%,30.70%,54.10%,33.70%,19.00%,2952,158,845,277,0,1280,69,603,481,1,1154,2952,187,964,345,1,1497,44,491,406,0,941
Fulton,07C,66.50%,58.50%,46.40%,59.60%,55.50%,44.30%,4512,163,657,438,8,1266,141,928,869,7,1945,4512,166,700,513,10,1389,135,874,757,5,1771
Fulton,07D,75.70%,59.90%,50.40%,68.10%,57.20%,47.50%,4879,188,821,189,13,1211,185,1228,588,19,2020,4879,198,874,242,12,1326,173,1170,517,17,1877
Fulton,07E,79.20%,66.00%,48.10%,74.20%,63.40%,44.70%,2247,53,316,138,3,510,48,614,526,4,1192,2247,54,338,166,3,561,43,586,478,3,1110
Fulton,07F,73.30%,61.80%,41.70%,65.80%,56.60%,36.80%,3790,157,650,221,26,1054,121,1051,608,10,1790,3790,171,739,274,25,1209,105,962,528,9,1604
Fulton,07H,75.50%,58.20%,40.40%,70.80%,53.10%,31.90%,2060,87,402,132,0,621,59,559,407,0,1025,2060,98,448,152,0,698,46,507,368,0,921
Fulton,07J,77.40%,66.90%,53.00%,70.00%,62.30%,45.60%,3041,104,448,149,6,707,118,904,509,6,1537,3041,126,505,196,5,832,105,835,457,5,1402
Fulton,07M,81.50%,65.10%,60.60%,78.20%,63.80%,60.50%,2401,71,295,86,0,452,109,551,379,0,1039,2401,70,304,96,0,470,107,535,345,0,987
Fulton,07N,86.90%,81.90%,74.50%,87.00%,82.30%,73.80%,2139,39,133,54,2,228,113,603,358,7,1081,2139,40,128,50,2,220,111,594,335,7,1047
Fulton,08A,62.70%,53.90%,42.70%,56.50%,50.20%,35.70%,3084,149,681,236,4,1070,108,795,397,6,1306,3084,170,730,271,5,1176,92,735,352,5,1184
Fulton,08B,66.10%,49.00%,37.60%,56.10%,42.00%,24.00%,3498,131,918,247,2,1298,80,883,481,0,1444,3498,164,1042,313,1,1520,52,756,400,0,1208
Fulton,08C,57.70%,36.40%,32.10%,49.20%,27.80%,23.50%,1500,55,490,146,0,691,26,281,199,0,506,1500,65,561,169,0,795,20,216,164,0,400
Fulton,08D,61.80%,33.90%,23.80%,49.60%,28.70%,19.00%,1073,36,372,97,12,517,8,191,157,7,363,1073,39,403,124,12,578,6,162,122,6,296
Fulton,08E,67.00%,43.30%,32.30%,57.10%,36.40%,22.60%,2568,104,741,231,3,1079,51,566,468,0,1085,2568,120,831,295,3,1249,36,475,392,0,903
Fulton,08F1,63.00%,44.20%,29.70%,49.30%,32.70%,16.80%,2187,102,662,190,2,956,42,524,323,2,891,2187,121,803,256,3,1183,24,390,249,1,664
Fulton,08G,73.10%,58.70%,50.70%,67.00%,55.90%,49.10%,3086,102,436,199,0,737,100,619,541,5,1265,3086,112,463,232,0,807,103,586,470,5,1164
Fulton,08H,68.30%,46.70%,31.10%,56.30%,38.30%,23.60%,2556,90,654,224,3,971,42,574,483,0,1099,2556,104,763,306,3,1176,33,474,394,0,901
Fulton,08J,71.50%,62.40%,45.80%,63.00%,52.70%,35.30%,3344,125,648,177,5,955,106,1076,444,4,1630,3344,152,823,228,4,1207,80,916,388,5,1389
Fulton,08K,82.60%,68.60%,42.60%,73.90%,63.10%,29.30%,1049,54,151,42,0,247,40,330,200,0,570,1049,70,176,63,0,309,29,301,178,0,508
Fulton,08L,82.80%,68.70%,55.40%,78.10%,64.20%,47.60%,4505,135,607,167,5,914,158,1334,802,16,2310,4505,159,692,207,6,1064,133,1243,739,17,2132
Fulton,08M,60.90%,43.50%,35.30%,49.70%,36.40%,27.70%,2295,127,628,182,5,942,70,483,284,2,839,2295,144,712,226,5,1087,54,408,223,3,688
Fulton,08N1,64.20%,47.00%,33.30%,49.50%,35.70%,26.80%,824,25,219,73,1,318,11,194,131,2,338,824,29,270,103,1,403,9,150,101,2,262
Fulton,08N2,68.40%,60.30%,53.10%,60.40%,55.40%,47.30%,1616,44,271,136,1,452,49,411,294,2,756,1616,48,303,161,1,513,43,377,246,1,667
Fulton,08P,82.70%,86.50%,72.20%,79.30%,83.40%,72.10%,1887,39,95,47,5,186,108,608,224,6,946,1887,39,115,54,4,212,105,577,207,6,895
Fulton,09A,85.80%,76.30%,67.10%,81.70%,74.20%,63.50%,3856,73,424,95,3,595,148,1367,576,7,2098,3856,82,464,119,3,668,143,1334,533,5,2015
Fulton,09B,97.10%,97.60%,90.00%,97.00%,97.60%,93.10%,464,3,2,2,0,7,27,80,68,0,175,464,2,2,2,0,6,27,80,65,0,172
Fulton,09C,97.50%,95.90%,93.90%,96.90%,96.80%,93.60%,3353,18,37,12,0,67,252,856,469,24,1601,3353,18,28,14,1,61,250,857,441,26,1574
Fulton,09D,94.20%,96.30%,94.50%,95.80%,96.00%,95.40%,2299,13,17,18,0,48,213,437,290,9,949,2299,11,18,12,0,41,218,428,277,10,933
Fulton,09E,94.30%,92.50%,90.00%,93.80%,92.80%,87.00%,3261,26,75,20,2,123,249,931,330,4,1514,3261,35,71,20,2,128,245,921,305,3,1474
Fulton,09F,75.60%,62.30%,49.40%,67.30%,58.40%,47.30%,3917,113,708,204,4,1029,112,1170,633,2,1917,3917,112,779,267,6,1164,106,1095,549,0,1750
Fulton,09G,84.70%,82.10%,62.20%,79.50%,78.90%,56.60%,3943,115,306,113,4,538,186,1406,626,10,2228,3943,129,362,146,6,643,168,1352,567,8,2095
Fulton,09H,90.90%,90.20%,81.20%,88.30%,89.00%,77.10%,1185,16,43,16,0,75,68,396,159,1,624,1185,19,48,20,0,87,63,387,151,1,602
Fulton,09I,97.20%,94.10%,90.50%,99.40%,91.70%,92.30%,1397,14,16,5,0,35,132,255,174,2,563,1397,11,22,1,0,34,130,244,173,1,548
Fulton,09K,97.60%,94.20%,92.30%,96.60%,94.40%,95.30%,4002,22,53,12,0,87,251,858,478,11,1598,4002,13,50,16,0,79,252,835,457,11,1555
Fulton,09K1,93.00%,94.20%,91.20%,92.70%,95.30%,94.50%,1518,10,19,3,0,32,102,309,40,2,453,1518,6,15,3,0,24,101,306,38,2,447
Fulton,09M,89.20%,85.10%,71.80%,84.30%,81.70%,68.20%,2578,35,201,43,0,279,89,1148,354,0,1591,2578,41,245,62,0,348,88,1093,334,0,1515
Fulton,10A,96.70%,96.00%,94.30%,98.10%,96.90%,95.40%,3186,15,39,18,0,72,231,948,529,16,1724,3186,12,30,10,0,52,235,944,517,16,1712
Fulton,10B,97.40%,97.10%,88.80%,98.00%,97.30%,94.30%,3965,25,44,24,3,96,215,1478,891,8,2592,3965,13,41,17,1,72,224,1471,853,9,2557
Fulton,10C,95.80%,97.50%,87.20%,96.10%,98.30%,93.30%,2598,19,18,14,1,52,121,698,319,15,1153,2598,10,12,12,0,34,125,681,295,15,1116
Fulton,10D,96.90%,96.70%,86.70%,96.10%,97.40%,90.70%,4968,44,39,18,20,121,280,1146,554,137,2117,4968,30,30,21,13,94,283,1126,519,135,2063
Fulton,10E,96.30%,94.20%,94.10%,95.10%,95.10%,94.90%,1084,6,18,7,0,31,92,291,182,4,569,1084,5,15,9,0,29,90,289,175,3,557
Fulton,10F,98.10%,94.90%,92.50%,98.00%,96.20%,94.30%,1208,10,16,4,1,31,121,300,203,14,638,1208,8,12,4,0,24,119,304,197,13,633
Fulton,10G,96.00%,96.60%,90.70%,97.90%,97.10%,87.90%,1332,10,18,10,0,38,94,508,238,4,844,1332,13,15,5,0,33,91,507,231,3,832
Fulton,10H1,98.80%,98.70%,87.20%,98.70%,96.80%,97.60%,439,3,2,1,2,8,23,154,81,11,269,439,1,5,1,0,7,26,151,75,14,266
Fulton,10H2,96.70%,95.90%,92.70%,96.60%,96.20%,96.30%,2623,14,24,12,0,50,163,556,349,15,1083,2623,7,21,11,0,39,171,535,314,13,1033
Fulton,10I,100.00%,96.40%,76.50%,98.90%,96.30%,75.00%,331,4,6,0,0,10,13,159,92,0,264,331,4,6,1,0,11,12,157,87,0,256
Fulton,10J,94.80%,97.00%,93.60%,95.30%,96.90%,93.90%,1238,10,6,7,1,24,146,191,128,14,479,1238,10,6,6,0,22,143,186,122,12,463
Fulton,10K,98.70%,94.90%,88.70%,98.00%,94.60%,92.90%,1614,13,30,4,0,47,97,560,310,5,972,1614,8,31,6,0,45,100,548,298,4,950
Fulton,10M,94.70%,96.40%,94.60%,95.80%,96.90%,96.50%,2880,14,32,24,0,70,232,857,429,13,1531,2880,9,27,18,0,54,236,854,411,12,1513
Fulton,10P,97.20%,96.60%,92.30%,97.40%,96.80%,92.80%,1607,11,12,7,1,31,140,336,241,3,720,1607,11,11,6,0,28,137,330,228,4,699
Fulton,10R,97.70%,93.70%,93.90%,96.10%,96.50%,96.40%,928,6,13,2,1,22,96,193,84,12,385,928,3,7,3,1,14,97,193,74,11,375
Fulton,11B,97.70%,97.50%,94.00%,98.30%,97.10%,94.50%,4395,19,34,20,4,77,331,1344,853,29,2557,4395,17,40,14,4,75,326,1328,812,33,2499
Fulton,11B1,93.30%,96.70%,85.90%,96.40%,97.30%,92.70%,894,12,10,2,0,24,66,291,28,7,392,894,6,8,1,0,15,71,289,27,5,392
Fulton,11C,98.50%,97.70%,92.80%,98.40%,98.10%,93.90%,3149,13,31,9,0,53,156,1338,589,12,2095,3149,11,26,9,0,46,155,1333,569,13,2070
Fulton,1.10E+02,97.60%,96.80%,86.60%,96.40%,95.30%,88.80%,1340,17,13,4,3,37,110,394,165,19,688,1340,13,19,6,3,41,110,382,161,17,670
Fulton,1.10E+03,97.60%,97.20%,88.50%,98.10%,97.40%,92.80%,1003,10,10,4,0,24,73,344,160,4,581,1003,6,9,3,0,18,73,338,154,4,569
Fulton,1.10E+04,98.10%,97.50%,92.60%,98.50%,97.20%,94.90%,3605,19,35,7,3,64,260,1361,352,15,1988,3605,12,39,5,3,59,265,1350,335,14,1964
Fulton,11G,95.80%,95.00%,92.70%,96.80%,93.40%,92.40%,2556,8,26,14,3,51,114,495,323,25,957,2556,8,33,10,3,54,107,466,301,27,901
Fulton,11H,94.40%,95.90%,83.90%,94.80%,96.30%,89.30%,753,9,8,8,1,26,46,185,135,6,372,753,6,7,7,0,20,45,184,127,5,361
Fulton,11J,98.60%,97.40%,92.10%,97.60%,96.20%,92.70%,2092,17,14,5,0,36,174,523,347,24,1068,2092,13,20,8,2,43,172,503,319,19,1013
Fulton,11K,97.50%,96.10%,88.60%,97.20%,96.50%,91.90%,2045,13,25,10,5,53,132,621,397,8,1158,2045,9,22,11,4,46,139,612,381,9,1141
Fulton,11M,98.40%,97.90%,89.10%,98.90%,98.60%,92.30%,1380,13,12,6,0,31,95,568,363,11,1037,1380,8,8,4,1,21,98,571,357,10,1036
Fulton,11M1,98.20%,95.20%,93.00%,100.00%,95.60%,92.90%,2190,11,26,1,1,39,132,520,54,27,733,2190,10,24,0,2,36,132,517,56,24,729
Fulton,11N,95.30%,96.70%,90.20%,95.70%,96.70%,93.50%,2431,18,28,22,2,70,182,812,444,2,1440,2431,11,27,19,2,59,184,802,426,2,1414
Fulton,11P,97.30%,96.50%,94.70%,96.60%,98.00%,94.60%,2095,7,20,11,1,39,128,550,395,15,1088,2095,5,11,13,3,32,129,548,372,11,1060
Fulton,11R,97.50%,95.30%,93.20%,97.40%,96.60%,94.60%,2253,8,22,6,1,37,118,451,235,5,809,2253,6,16,6,1,29,117,450,222,5,794
Fulton,12A,95.60%,94.30%,86.30%,95.30%,94.40%,87.70%,4971,44,97,35,3,179,272,1610,758,23,2663,4971,40,95,35,2,172,276,1594,715,23,2608
Fulton,12A1,83.30%,97.50%,84.30%,90.50%,95.80%,83.30%,690,8,8,4,0,20,35,308,20,8,371,690,6,13,2,2,23,34,300,19,6,359
Fulton,12D,96.60%,95.80%,90.90%,97.00%,94.90%,89.80%,1408,10,15,5,0,30,98,345,141,2,586,1408,11,18,4,0,33,95,336,131,2,564
Fulton,1.20E+02,89.50%,92.30%,92.60%,89.40%,93.90%,90.80%,1906,9,25,29,1,64,122,299,246,4,671,1906,12,19,27,0,58,114,292,227,4,637
Fulton,12F,95.80%,95.10%,91.70%,95.50%,94.40%,94.90%,1229,10,15,4,0,29,108,294,92,2,496,1229,6,17,4,0,27,110,289,85,2,486
Fulton,12G,93.40%,95.90%,93.70%,93.50%,94.30%,95.10%,885,4,8,13,0,25,58,188,184,1,431,885,3,11,12,0,26,57,182,174,1,414
Fulton,12H1,90.10%,93.40%,89.70%,92.20%,93.30%,97.20%,1170,10,12,8,2,32,91,169,73,13,346,1170,3,12,6,0,21,94,167,71,12,344
Fulton,12H2,97.60%,97.20%,95.70%,97.20%,97.40%,94.00%,2998,13,20,10,0,43,276,702,400,11,1389,2998,18,18,11,0,47,274,683,381,10,1348
Fulton,12I,98.70%,96.80%,88.70%,98.00%,96.10%,91.40%,1079,8,8,2,4,22,54,242,155,40,491,1079,5,9,3,4,21,55,223,147,41,466
Fulton,12J,96.60%,95.00%,90.50%,97.10%,96.30%,92.90%,3154,27,37,12,2,78,243,708,342,34,1327,3154,18,27,10,3,58,246,702,331,29,1308
Fulton,12K,93.90%,94.00%,90.50%,94.40%,94.50%,91.80%,3620,17,60,24,4,105,190,942,371,9,1512,3620,14,54,21,4,93,194,923,351,8,1476
Fulton,12L,94.70%,93.20%,93.80%,95.60%,93.00%,98.40%,774,2,10,4,2,18,57,137,71,3,268,774,0,10,3,1,14,56,133,65,4,258
Fulton,12M,97.50%,96.70%,90.30%,97.70%,97.40%,93.80%,2990,35,22,8,4,69,345,635,312,20,1312,2990,22,17,7,2,48,343,625,299,21,1288
Fulton,12N,94.30%,96.90%,94.50%,93.90%,97.80%,93.60%,1134,6,7,5,0,18,89,216,83,14,402,1134,6,5,5,1,17,91,218,77,11,397
Fulton,12S,96.50%,97.30%,92.10%,97.90%,97.40%,94.10%,2079,14,16,9,1,40,162,575,245,14,996,2079,10,15,5,1,31,163,567,233,14,977
Fulton,AP01A,66.30%,49.80%,40.30%,60.60%,46.80%,40.90%,5236,178,1275,410,1,1864,117,1266,808,4,2195,5236,178,1355,471,0,2004,119,1191,724,4,2038
Fulton,AP01B,63.00%,52.50%,47.60%,59.10%,52.50%,40.00%,1281,51,255,91,3,400,44,282,155,5,486,1281,58,252,96,5,411,38,279,139,4,460
Fulton,AP01C,70.80%,46.60%,41.70%,64.00%,42.60%,39.00%,2409,81,646,145,7,879,58,564,351,5,978,2409,79,697,177,7,960,50,518,314,5,887
Fulton,AP01D,68.50%,54.40%,53.00%,65.40%,53.10%,54.40%,1015,31,183,64,0,278,35,218,139,0,392,1015,31,189,66,0,286,37,214,125,0,376
Fulton,AP021,61.60%,48.40%,39.90%,58.10%,45.60%,38.80%,3408,164,878,224,0,1266,105,822,360,4,1291,3408,163,915,234,1,1313,101,768,324,3,1196
Fulton,AP022,67.30%,50.60%,53.20%,62.80%,50.00%,52.50%,2507,88,504,186,0,778,100,517,383,0,1000,2507,86,501,203,0,790,95,500,343,0,938
Fulton,AP02B,62.10%,60.60%,27.10%,56.80%,58.90%,29.80%,677,30,87,81,5,203,9,134,133,4,280,677,28,90,89,5,212,10,129,117,4,260
Fulton,AP03,82.20%,77.00%,70.90%,81.20%,77.20%,74.00%,775,31,56,13,1,101,73,187,60,5,325,775,26,54,13,1,94,72,183,56,5,316
Fulton,AP04A,54.40%,43.20%,38.80%,48.50%,40.80%,34.60%,1760,74,485,200,5,764,46,369,239,4,658,1760,80,504,224,5,813,41,347,211,4,603
Fulton,AP04B,72.60%,45.60%,24.50%,70.70%,41.10%,20.00%,473,38,142,23,2,205,9,119,61,4,193,473,40,152,24,0,216,6,106,58,4,174
Fulton,AP05,64.70%,47.80%,29.30%,58.10%,45.20%,26.70%,4776,271,1184,398,4,1857,105,1084,729,9,1927,4776,279,1235,461,6,1981,99,1019,639,5,1762
Fulton,AP06,62.60%,39.50%,26.90%,56.10%,35.70%,24.30%,1967,118,612,148,10,888,41,399,248,6,694,1967,117,647,170,14,948,42,360,217,0,619
Fulton,AP07A,63.60%,48.10%,41.30%,60.50%,46.50%,38.20%,3910,178,887,291,14,1370,125,821,508,10,1464,3910,185,899,303,11,1398,112,782,464,9,1367
Fulton,AP07B,59.10%,47.90%,43.70%,55.80%,44.20%,40.40%,1882,79,499,167,10,755,59,458,241,10,768,1882,82,534,173,11,800,55,423,218,8,704
Fulton,AP09A,68.60%,52.70%,41.50%,62.20%,51.40%,39.70%,4437,203,983,315,7,1508,144,1096,688,5,1933,4437,207,995,365,6,1573,134,1054,601,6,1795
Fulton,AP09B,79.60%,61.00%,46.70%,79.50%,59.50%,32.80%,925,32,162,44,0,238,26,253,172,2,453,925,43,167,43,0,253,19,245,167,2,433
Fulton,AP10,56.70%,37.00%,38.40%,47.30%,34.30%,33.00%,992,46,323,84,23,476,25,190,110,18,343,992,44,335,99,23,501,22,175,89,11,297
Fulton,AP12A,69.90%,60.80%,62.80%,69.20%,58.80%,61.70%,746,29,116,37,3,185,39,180,86,15,320,746,29,121,36,2,188,38,173,81,12,304
Fulton,AP12B,65.80%,69.60%,59.30%,65.10%,67.80%,64.60%,947,30,98,68,5,201,48,224,131,3,406,947,25,100,66,4,195,50,211,123,3,387
Fulton,AP12C,56.00%,42.40%,40.30%,50.10%,39.80%,37.80%,2367,96,671,179,9,955,63,493,228,8,792,2367,96,694,195,11,996,59,458,196,6,719
Fulton,AP14,70.80%,48.50%,43.40%,65.10%,47.10%,39.30%,3232,98,825,233,5,1161,74,776,564,5,1419,3232,99,846,269,6,1220,65,753,501,3,1322
Fulton,CH01,68.50%,77.70%,44.40%,71.40%,77.50%,42.30%,376,14,29,17,1,61,9,101,37,3,150,376,14,29,14,1,58,8,100,35,3,146
Fulton,CH02,46.40%,38.50%,29.20%,50.70%,37.70%,29.80%,338,34,80,37,0,151,14,50,32,0,96,338,33,81,33,0,147,14,49,34,0,97
Fulton,CH03,39.00%,34.40%,19.40%,40.40%,33.90%,20.00%,410,54,118,36,0,208,13,62,23,0,98,410,52,117,34,0,203,13,60,23,0,96
Fulton,CH04A,63.40%,51.10%,26.20%,57.10%,48.40%,25.40%,825,45,217,59,0,321,16,227,102,0,345,825,47,226,67,0,340,16,212,89,0,317
Fulton,CH05,41.40%,24.50%,14.50%,42.40%,25.30%,13.20%,429,47,142,51,0,240,8,46,36,0,90,429,46,136,49,0,231,7,46,36,0,89
Fulton,CP011,85.30%,80.40%,76.10%,84.20%,78.60%,80.00%,1353,23,90,27,3,143,76,370,157,7,610,1353,21,98,28,1,148,80,359,149,8,596
Fulton,CP012,88.90%,82.00%,90.40%,87.10%,80.50%,88.40%,1469,8,108,26,1,143,79,493,208,6,786,1469,10,116,28,1,155,79,479,189,5,752
Fulton,CP01B,76.80%,73.40%,77.80%,70.60%,71.60%,68.00%,422,6,45,13,0,64,20,124,43,1,188,422,8,48,15,0,71,16,121,36,1,174
Fulton,CP02,90.20%,88.60%,80.50%,89.60%,88.80%,85.20%,1208,17,45,18,0,80,69,351,165,1,586,1208,13,44,18,0,75,74,350,155,1,580
Fulton,CP04A,0.00%,66.70%,0.00%,0.00%,66.70%,0.00%,13,0,1,1,0,2,0,2,0,0,2,13,0,1,1,0,2,0,2,0,0,2
Fulton,CP04B,77.80%,87.50%,100.00%,87.50%,85.70%,100.00%,38,0,1,2,0,3,2,7,7,0,16,38,0,1,1,0,2,2,6,7,0,15
Fulton,CP051,97.00%,95.60%,92.70%,96.50%,96.90%,95.20%,1756,11,24,8,0,43,140,526,255,0,921,1756,7,17,9,0,33,139,527,251,0,917
Fulton,CP05B,90.90%,95.20%,91.70%,90.90%,95.20%,91.30%,153,2,2,1,0,5,18,40,10,4,72,153,2,2,1,0,5,17,40,10,4,71
Fulton,CP06A,92.30%,95.60%,90.60%,97.40%,94.10%,89.30%,732,4,6,3,1,14,48,130,36,0,214,732,5,8,1,1,15,50,128,38,0,216
Fulton,CP07B,0.00%,50.00%,100.00%,0.00%,50.00%,50.00%,7,0,1,0,0,1,2,1,0,0,3,7,1,1,0,0,2,1,1,0,0,2
Fulton,CP07C,100.00%,97.70%,100.00%,100.00%,97.70%,94.40%,323,0,1,0,0,1,18,43,10,0,71,323,1,1,0,0,2,17,42,10,0,69
Fulton,CP07D,92.50%,97.00%,93.80%,92.10%,95.30%,94.90%,790,4,4,3,0,11,60,128,37,0,225,790,3,6,3,0,12,56,122,35,0,213
Fulton,CP07E,100.00%,95.00%,100.00%,100.00%,94.70%,100.00%,127,0,1,0,0,1,19,19,3,0,41,127,0,1,0,0,1,18,18,3,0,39
Fulton,CP07F,75.00%,94.60%,100.00%,100.00%,97.20%,95.20%,266,0,2,1,0,3,23,35,3,0,61,266,1,1,0,0,2,20,35,5,0,60
Fulton,CP081,100.00%,98.20%,85.70%,100.00%,94.50%,87.20%,373,6,1,0,0,7,31,54,16,5,106,373,5,3,0,0,8,29,52,12,5,98
Fulton,CP083,100.00%,100.00%,100.00%,100.00%,95.20%,84.60%,240,0,0,0,0,0,13,20,3,0,36,240,2,1,0,0,3,11,20,3,0,34
Fulton,CP08A,100.00%,98.90%,92.50%,96.20%,97.60%,89.40%,756,5,1,0,0,6,62,86,29,0,177,756,7,2,1,0,10,59,82,25,0,166
Fulton,EP01A,89.40%,90.80%,84.90%,91.70%,91.10%,86.80%,2978,32,95,40,1,168,167,941,336,18,1462,2978,26,91,30,2,149,171,928,333,13,1445
Fulton,EP01B,93.00%,92.20%,86.10%,94.00%,93.00%,87.70%,3473,32,79,34,1,146,194,933,454,10,1591,3473,29,69,28,0,126,198,920,438,9,1565
Fulton,EP02A,94.60%,93.70%,92.10%,93.60%,95.10%,90.70%,2407,12,37,18,3,70,157,551,316,18,1042,2407,14,28,20,3,65,149,545,292,16,1002
Fulton,EP02B,88.60%,86.20%,81.40%,86.20%,86.20%,80.80%,1679,19,98,37,0,154,82,612,287,1,982,1679,20,98,43,0,161,83,610,269,1,963
Fulton,EP02C,83.10%,86.70%,66.70%,87.30%,86.50%,71.40%,522,7,28,13,0,48,14,183,64,0,261,522,6,28,9,0,43,15,180,62,0,257
Fulton,EP02D,94.20%,96.30%,90.60%,98.00%,96.90%,87.90%,420,3,6,3,0,12,29,155,49,0,233,420,4,5,1,0,10,29,156,49,0,234
Fulton,EP02E,93.80%,92.50%,94.50%,94.50%,92.30%,94.50%,1668,6,35,11,0,52,103,429,165,0,697,1668,6,35,9,0,50,103,419,156,0,678
Fulton,EP03A,93.90%,95.40%,86.00%,93.70%,95.20%,88.20%,4925,48,75,54,1,178,291,1544,830,9,2674,4925,40,77,53,0,170,291,1539,790,8,2628
Fulton,EP03B,97.20%,93.40%,89.20%,96.60%,93.60%,88.00%,1547,9,42,10,0,61,69,596,350,5,1020,1547,10,41,12,0,63,68,595,338,5,1006
Fulton,EP04A,96.20%,96.90%,93.90%,96.90%,96.60%,94.10%,5020,35,42,27,0,104,506,1330,677,37,2550,5020,33,47,21,1,102,510,1320,649,34,2513
Fulton,EP04B,96.50%,97.10%,91.10%,98.50%,97.70%,94.60%,2624,13,32,10,2,57,147,1059,277,7,1490,2624,8,25,4,1,38,148,1059,268,9,1484
Fulton,EP04C,97.70%,96.60%,80.00%,97.40%,96.30%,80.00%,1318,0,14,1,1,16,0,395,42,4,441,1318,0,15,1,1,17,0,390,38,4,432
Fulton,FA01A,89.40%,88.80%,81.50%,89.20%,89.60%,83.90%,4032,51,176,72,1,300,213,1389,605,16,2223,4032,44,160,69,0,273,219,1385,570,11,2185
Fulton,FA01B,88.80%,90.40%,87.20%,89.20%,90.20%,84.60%,5860,4,235,105,1,345,27,2218,835,7,3087,5860,5,237,95,1,338,25,2191,788,8,3012
Fulton,FA01C,94.60%,93.30%,90.90%,94.30%,94.00%,93.80%,769,6,20,6,0,32,59,279,106,1,445,769,4,18,6,0,28,60,281,100,1,442
Fulton,FA01D,75.00%,93.10%,86.50%,83.30%,92.20%,91.90%,321,2,9,2,3,16,19,121,6,13,159,321,2,10,1,1,14,19,118,5,15,157
Fulton,FC01,92.90%,96.90%,85.20%,100.00%,98.40%,87.50%,325,4,4,2,0,10,20,126,26,3,175,325,3,2,0,0,5,19,125,23,2,169
Fulton,FC02,66.70%,83.90%,70.00%,75.00%,87.10%,75.00%,585,6,5,3,0,14,11,26,6,3,46,585,4,4,2,0,10,11,27,6,1,45
Fulton,FC03,0.00%,87.50%,100.00%,0.00%,87.50%,100.00%,17,0,1,0,0,1,1,7,0,8,16,17,0,1,0,0,1,1,7,0,8,16
Fulton,HP01,81.70%,74.90%,64.10%,81.00%,74.60%,65.30%,3824,154,301,100,1,556,270,899,446,7,1622,3824,145,299,98,1,543,268,878,417,7,1570
Fulton,JC01,78.10%,60.80%,41.70%,74.60%,58.90%,39.70%,4128,192,729,271,5,1197,135,1130,967,6,2238,4128,197,757,306,5,1265,129,1085,898,4,2116
Fulton,JC01A,75.30%,66.40%,44.60%,76.60%,66.60%,46.20%,1738,100,235,38,3,376,80,465,116,3,664,1738,96,231,34,3,364,81,461,111,4,657
Fulton,JC02,69.80%,55.40%,44.60%,66.60%,54.40%,46.60%,3001,132,529,234,2,897,104,657,541,4,1306,3001,123,535,248,2,908,105,639,494,4,1242
Fulton,JC03A,70.80%,59.60%,34.50%,69.00%,56.40%,30.90%,594,34,136,26,2,198,16,201,63,3,283,594,36,147,27,2,212,14,190,60,3,267
Fulton,JC03B,80.40%,59.50%,46.40%,78.60%,57.20%,45.60%,1616,81,299,65,0,445,70,440,267,0,777,1616,81,309,69,0,459,68,413,253,0,734
Fulton,JC04A,74.00%,54.00%,36.30%,68.70%,50.20%,34.40%,3177,92,771,197,10,1070,49,904,560,9,1522,3177,94,832,228,9,1163,46,840,500,8,1394
Fulton,JC04B,69.00%,66.20%,30.80%,62.30%,64.30%,33.30%,334,9,49,22,0,80,4,96,49,0,149,334,10,50,26,0,86,5,90,43,0,138
Fulton,JC04C,80.60%,57.00%,33.80%,74.00%,54.70%,33.80%,1251,43,264,54,0,361,22,350,224,0,596,1251,43,269,71,0,383,22,325,202,0,549
Fulton,JC05,75.40%,57.40%,38.90%,72.20%,54.20%,34.80%,2350,100,491,107,2,700,63,661,328,2,1054,2350,106,523,116,1,746,54,618,301,3,976
Fulton,JC06,64.60%,48.70%,44.30%,60.40%,45.50%,43.50%,2840,153,581,229,4,967,121,551,418,4,1094,2840,153,616,246,4,1019,117,514,375,4,1010
Fulton,JC07,73.00%,56.00%,41.80%,70.30%,53.40%,41.90%,4670,146,922,315,20,1403,104,1174,852,15,2145,4670,143,966,337,18,1464,102,1106,796,14,2018
Fulton,JC08,70.20%,51.40%,40.70%,66.90%,48.80%,40.60%,2931,111,718,183,1,1013,73,759,431,4,1267,2931,110,742,199,1,1052,72,706,403,4,1185
Fulton,JC09,71.60%,57.30%,45.20%,68.50%,56.20%,44.40%,3250,133,618,192,4,947,111,828,485,2,1426,3250,135,632,201,4,972,109,810,437,2,1358
Fulton,JC10,73.30%,61.50%,44.70%,74.80%,60.20%,41.90%,2641,111,445,159,10,725,88,712,436,10,1246,2641,116,451,142,9,718,82,683,421,8,1194
Fulton,JC11,63.60%,44.70%,37.00%,58.30%,41.80%,37.90%,3497,177,920,267,0,1364,104,744,466,0,1314,3497,174,955,297,0,1426,106,687,415,0,1208
Fulton,JC12,54.30%,34.50%,27.10%,50.00%,31.60%,25.40%,2832,99,888,338,3,1328,35,467,402,3,907,2832,100,925,363,3,1391,33,428,363,2,826
Fulton,JC13A,57.70%,36.20%,34.30%,51.20%,32.80%,27.50%,2317,89,769,208,1,1067,46,437,284,1,768,2317,99,806,233,1,1139,37,394,244,1,676
Fulton,JC13B,47.50%,28.10%,18.20%,41.70%,22.60%,18.20%,282,8,115,32,1,156,2,45,29,0,76,282,8,123,35,1,167,2,36,25,0,63
Fulton,JC14,65.90%,44.80%,41.30%,57.50%,41.90%,41.10%,2608,83,771,185,1,1040,57,625,358,2,1042,2608,82,811,223,1,1117,56,586,302,2,946
Fulton,JC15,71.50%,60.00%,50.70%,70.20%,60.40%,55.20%,959,34,185,47,0,266,35,277,118,0,430,959,30,178,48,0,256,37,271,113,0,421
Fulton,JC16,70.30%,49.30%,32.30%,67.40%,48.10%,30.50%,2707,132,683,161,0,976,62,663,382,1,1108,2707,138,685,171,1,995,61,635,354,0,1050
Fulton,JC18,64.80%,44.60%,42.40%,58.40%,42.10%,34.60%,2857,86,848,216,1,1151,62,684,398,2,1146,2857,101,886,249,1,1237,52,644,350,2,1048
Fulton,JC19,72.50%,51.10%,45.70%,68.80%,49.30%,44.50%,4174,120,987,250,5,1362,96,1030,659,9,1794,4174,121,1021,273,6,1421,95,991,603,7,1696
Fulton,ML01A,62.00%,43.70%,33.30%,55.10%,39.80%,26.90%,2795,141,885,189,21,1236,68,688,309,13,1078,2795,148,943,220,23,1334,53,623,270,10,956
Fulton,ML01B,53.20%,33.70%,19.20%,46.00%,33.10%,20.40%,708,42,238,66,0,346,10,121,75,0,206,708,39,240,74,0,353,10,119,63,0,192
Fulton,ML02A,53.60%,26.20%,25.50%,47.70%,23.60%,20.70%,2580,231,929,234,3,1397,80,329,270,0,679,2580,246,959,261,3,1469,65,296,238,0,599
Fulton,ML02B,49.40%,33.80%,28.80%,42.70%,30.00%,24.30%,1914,130,632,197,1,960,52,323,192,1,568,1914,136,669,216,1,1022,43,287,161,1,492
Fulton,ML03,50.00%,33.30%,27.30%,43.80%,30.40%,23.60%,3718,240,1270,387,5,1902,90,635,387,2,1114,3718,256,1323,423,3,2005,77,577,329,3,986
Fulton,ML03A,42.30%,30.10%,19.00%,40.90%,24.20%,15.00%,301,15,114,15,2,146,4,49,11,0,64,301,15,125,13,2,155,3,40,9,0,52
Fulton,ML04,52.80%,37.90%,27.20%,49.50%,35.50%,26.60%,3322,207,1024,325,20,1576,74,626,364,11,1075,3322,203,1070,339,21,1633,73,588,332,8,1001
Fulton,ML05,65.30%,47.30%,34.90%,61.70%,45.10%,34.80%,4843,253,1170,359,12,1794,140,1051,676,2,1869,4843,250,1210,381,11,1852,136,993,615,3,1747
Fulton,ML06A,74.20%,70.00%,48.80%,73.80%,68.10%,49.00%,2181,101,256,84,5,446,98,597,241,3,939,2181,102,267,81,1,451,95,569,228,4,896
Fulton,ML06B,77.50%,61.90%,50.80%,74.50%,62.10%,49.40%,3119,127,506,138,3,774,132,821,476,2,1431,3119,128,500,151,4,783,127,818,440,2,1387
Fulton,ML07A,52.00%,37.90%,16.10%,49.00%,35.30%,12.90%,836,120,218,73,0,411,23,133,79,0,235,836,121,227,77,0,425,18,124,74,0,216
Fulton,ML07B,51.00%,35.70%,20.20%,49.80%,33.40%,17.80%,1675,217,471,153,0,841,54,262,159,1,476,1675,221,489,150,0,860,47,245,149,1,442
Fulton,MP01,73.80%,52.10%,42.70%,72.20%,51.40%,40.60%,472,121,34,21,4,180,91,37,59,2,189,472,123,34,22,3,182,84,36,57,2,179
Fulton,PA01,72.90%,79.40%,75.60%,72.50%,79.40%,75.30%,3006,55,225,126,5,411,172,868,339,14,1393,3006,54,224,122,5,405,167,864,322,13,1366
Fulton,RW01,57.40%,40.80%,31.30%,52.60%,37.90%,29.70%,5010,193,1455,619,9,2276,88,1003,833,4,1928,5010,197,1507,662,9,2375,84,921,735,3,1743
Fulton,RW02,67.90%,48.70%,36.20%,61.80%,44.80%,31.10%,4061,212,979,324,8,1523,118,928,684,7,1737,4061,235,1046,376,6,1663,102,848,608,7,1565
Fulton,RW03,71.80%,57.50%,47.30%,69.20%,55.40%,45.60%,5041,232,834,272,9,1347,210,1130,692,6,2038,5041,232,867,285,8,1392,194,1075,639,7,1915
Fulton,RW04,72.30%,52.60%,36.30%,64.60%,50.80%,30.70%,1861,65,454,131,0,650,36,504,342,1,883,1861,70,462,165,0,697,31,477,301,0,809
Fulton,RW05,72.70%,64.40%,63.80%,69.80%,64.30%,62.20%,2910,111,368,133,3,615,190,665,354,11,1220,2910,112,361,140,4,617,181,651,324,10,1166
Fulton,RW06,73.80%,56.10%,39.60%,69.40%,53.90%,35.20%,3071,151,630,153,0,934,91,805,431,8,1335,3071,162,662,174,2,1000,84,774,394,5,1257
Fulton,RW07A,89.70%,83.90%,79.50%,88.30%,83.60%,80.70%,1773,49,78,18,0,145,188,407,157,2,754,1773,44,78,19,0,141,182,399,143,2,726
Fulton,RW07B,81.90%,70.80%,69.40%,80.90%,70.60%,71.80%,449,20,35,13,6,74,45,85,59,14,203,449,19,35,13,5,72,46,84,55,15,200
Fulton,RW08,54.60%,41.10%,32.00%,45.80%,37.50%,27.80%,2429,145,554,303,6,1008,67,387,365,4,823,2429,151,587,352,5,1095,56,352,297,4,709
Fulton,RW09,56.30%,36.30%,25.00%,50.10%,34.20%,21.00%,4450,262,1362,603,2,2229,86,776,777,2,1641,4450,278,1403,672,1,2354,72,728,676,2,1478
Fulton,RW09A,60.60%,37.00%,25.00%,51.50%,34.40%,21.30%,1892,122,617,56,7,802,42,362,86,1,491,1892,130,636,66,7,839,36,333,70,1,440
Fulton,RW10,58.50%,41.90%,25.50%,52.00%,37.40%,22.40%,3653,182,1028,384,5,1599,57,742,541,7,1347,3653,185,1107,429,6,1727,49,661,464,6,1180
Fulton,RW11A,68.20%,51.60%,46.20%,63.80%,48.40%,44.30%,2865,135,553,207,5,900,114,590,444,6,1154,2865,136,585,226,5,952,107,549,399,5,1060
Fulton,RW12,62.90%,42.40%,26.90%,57.60%,38.90%,23.00%,3899,275,1087,485,2,1849,100,799,822,2,1723,3899,292,1155,538,2,1987,86,735,730,2,1553
Fulton,RW12A,58.40%,46.70%,38.10%,53.30%,43.20%,33.00%,2458,129,606,79,4,818,79,531,111,3,724,2458,138,644,86,4,872,67,489,98,3,657
Fulton,RW13,66.00%,52.00%,41.60%,59.20%,48.70%,37.50%,3764,200,870,254,5,1329,142,943,494,4,1583,3764,219,926,298,4,1447,130,878,433,4,1445
Fulton,RW16,62.10%,45.40%,31.20%,56.60%,41.60%,28.70%,2101,117,567,170,2,856,50,472,278,4,804,2101,116,606,193,3,918,45,432,252,3,732
Fulton,RW17,75.30%,62.10%,51.30%,73.40%,60.70%,52.80%,3100,148,484,131,2,765,154,793,400,4,1351,3100,142,496,135,1,774,156,765,373,4,1298
Fulton,RW19,61.70%,40.90%,32.20%,55.40%,37.30%,27.50%,2147,115,650,184,1,950,54,450,296,1,801,2147,120,688,208,1,1017,46,409,258,0,713
Fulton,RW20,63.40%,48.10%,40.00%,59.60%,45.10%,36.30%,2701,75,750,214,6,1045,52,694,371,2,1119,2701,82,792,230,4,1108,46,651,339,3,1039
Fulton,RW21,58.60%,40.10%,46.80%,53.20%,37.60%,47.00%,3362,89,1032,289,10,1420,77,690,409,10,1186,3362,86,1076,317,11,1490,76,648,360,10,1094
Fulton,RW22A,70.30%,64.30%,57.50%,67.20%,62.10%,59.60%,4788,143,726,221,10,1100,200,1309,524,7,2040,4788,133,765,232,8,1138,201,1251,475,7,1934
Fulton,SC01A,100.00%,93.20%,100.00%,100.00%,90.70%,100.00%,41,0,3,0,0,3,2,41,7,0,50,41,0,4,0,0,4,2,39,7,0,48
Fulton,SC01B,96.40%,97.70%,91.70%,96.00%,97.70%,93.90%,2088,11,26,11,1,49,115,1129,296,17,1557,2088,8,26,12,1,47,122,1118,288,16,1544
Fulton,SC01C,96.00%,96.90%,92.90%,96.10%,97.00%,93.70%,2249,5,34,19,2,60,83,1051,456,9,1599,2249,4,33,18,2,57,82,1054,439,7,1582
Fulton,SC02,97.90%,96.50%,97.70%,98.10%,96.80%,97.90%,1426,1,26,6,0,33,40,715,274,2,1031,1426,1,24,5,0,30,43,717,263,3,1026
Fulton,SC04,78.30%,74.60%,52.70%,76.10%,73.70%,54.30%,1080,60,107,40,1,208,62,315,144,6,527,1080,57,110,42,1,210,64,309,134,5,512
Fulton,SC05A,96.70%,97.20%,93.70%,93.20%,99.40%,95.00%,721,4,9,3,0,16,53,312,87,6,458,721,3,2,6,0,11,52,314,82,5,453
Fulton,SC05B,95.40%,97.10%,91.90%,95.00%,97.20%,92.80%,3646,15,53,24,1,93,175,1763,498,7,2443,3646,14,50,25,0,89,172,1753,475,8,2408
Fulton,SC05D,95.50%,96.20%,93.70%,96.40%,97.00%,95.30%,2808,12,51,17,0,80,176,1287,364,2,1829,2808,9,40,13,0,62,180,1285,350,2,1817
Fulton,SC05E,79.90%,87.60%,79.60%,78.50%,88.80%,79.20%,688,10,34,30,0,74,36,241,119,3,399,688,9,31,31,1,72,36,246,113,2,397
Fulton,SC07A,91.60%,88.80%,82.70%,91.20%,89.30%,87.20%,4506,48,224,93,0,365,218,1784,1015,11,3028,4506,34,213,94,0,341,221,1779,975,10,2985
Fulton,SC07C,66.70%,100.00%,100.00%,33.30%,100.00%,100.00%,41,0,0,1,0,1,1,8,2,0,11,41,0,0,2,0,2,1,8,1,0,10
Fulton,SC07D,92.60%,96.20%,94.40%,93.30%,96.50%,93.40%,2038,8,33,7,0,48,130,839,87,4,1060,2038,9,30,6,0,45,124,836,83,4,1047
Fulton,SC08B,94.10%,96.70%,89.50%,95.30%,96.60%,92.20%,4096,29,53,40,2,124,250,1537,641,14,2442,4096,21,54,30,2,107,255,1516,613,15,2399
Fulton,SC08C,100.00%,100.00%,100.00%,94.40%,97.80%,100.00%,91,0,0,0,0,0,6,47,18,0,71,91,0,1,1,0,2,6,45,17,0,68
Fulton,SC08D,95.10%,97.00%,100.00%,96.30%,97.90%,100.00%,605,0,7,4,0,11,38,229,78,0,345,605,0,5,3,0,8,40,231,79,0,350
Fulton,SC08E,98.50%,95.70%,95.00%,98.40%,98.00%,100.00%,724,3,13,1,0,17,53,291,65,4,413,724,0,6,1,0,7,59,294,63,4,420
Fulton,SC08F,99.00%,98.30%,82.20%,99.00%,98.20%,88.40%,793,8,5,1,0,14,36,283,100,1,420,793,5,5,1,0,11,37,280,97,1,415
Fulton,SC08G,0.00%,100.00%,0.00%,0.00%,100.00%,0.00%,14,0,0,0,0,0,0,3,0,0,3,14,0,0,0,0,0,0,3,0,0,3
Fulton,SC09A,95.40%,94.60%,97.40%,94.50%,95.20%,97.90%,1865,5,30,11,0,46,179,525,227,12,943,1865,3,26,12,1,42,180,519,206,10,915
Fulton,SC09B,97.60%,97.20%,87.70%,98.10%,96.70%,94.70%,1920,15,21,9,1,46,111,720,368,3,1202,1920,7,24,7,0,38,123,706,356,2,1187
Fulton,SC09C,96.40%,96.40%,87.80%,96.90%,96.60%,92.50%,1852,22,20,11,1,54,165,535,297,1,998,1852,14,19,9,0,42,172,532,285,1,990
Fulton,SC10,93.90%,96.40%,87.90%,95.10%,96.10%,93.60%,1912,19,16,12,2,49,144,430,186,8,768,1912,11,17,9,0,37,153,420,175,9,757
Fulton,SC11A,96.30%,96.20%,92.50%,97.30%,97.30%,94.20%,1656,10,21,10,3,44,140,537,262,21,960,1656,9,15,7,1,32,141,533,254,22,950
Fulton,SC11B,97.20%,94.80%,89.80%,98.10%,95.70%,90.60%,1691,13,29,9,0,51,109,530,314,6,959,1691,12,24,6,0,42,110,530,306,6,952
Fulton,SC13,96.60%,94.50%,87.60%,95.10%,94.90%,89.10%,2895,21,77,15,2,115,157,1321,421,5,1904,2895,19,70,20,0,109,148,1312,389,7,1856
Fulton,SC14A,99.00%,93.10%,88.20%,100.00%,94.90%,94.10%,1030,8,23,1,0,32,60,310,104,0,474,1030,4,17,0,0,21,64,318,94,0,476
Fulton,SC15,93.60%,95.60%,90.10%,93.30%,96.20%,92.70%,4522,28,92,56,0,176,251,1976,817,5,3049,4522,21,77,56,0,154,262,1969,774,5,3010
Fulton,SC15A,98.30%,98.00%,92.40%,97.20%,98.10%,94.20%,2482,11,27,2,0,40,133,1300,113,0,1546,2482,8,25,3,0,36,131,1288,106,0,1525
Fulton,SC16A,97.50%,97.80%,89.80%,97.50%,97.90%,94.40%,5175,31,54,23,0,108,273,2446,881,0,3600,5175,17,52,22,0,91,286,2433,854,0,3573
Fulton,SC17A,90.90%,100.00%,100.00%,90.00%,96.70%,100.00%,60,0,0,1,0,1,1,32,10,0,43,60,0,1,1,0,2,1,29,9,0,39
Fulton,SC17B,0.00%,50.00%,100.00%,0.00%,50.00%,100.00%,10,0,1,0,0,1,0,1,0,3,4,10,0,1,0,0,1,0,1,0,3,4
Fulton,SC17C,95.40%,95.30%,83.60%,94.80%,95.40%,87.30%,1293,12,24,9,0,45,61,486,185,0,732,1293,9,23,10,0,42,62,482,181,0,725
Fulton,SC18A,99.20%,96.50%,90.70%,98.20%,95.50%,92.90%,570,4,8,1,0,13,39,220,121,0,380,570,3,10,2,0,15,39,213,111,0,363
Fulton,SC18B,94.60%,97.20%,95.30%,95.00%,97.20%,95.30%,915,2,13,9,0,24,41,456,157,0,654,915,2,13,8,0,23,41,452,152,0,645
Fulton,SC18C,95.10%,96.10%,89.20%,96.30%,96.30%,92.60%,2100,9,41,22,0,72,74,1007,426,0,1507,2100,6,38,16,0,60,75,1000,420,0,1495
Fulton,SC19A,91.50%,97.70%,83.30%,91.10%,98.90%,57.10%,213,1,2,4,0,7,4,86,43,1,134,213,3,1,4,0,8,3,88,41,1,133
Fulton,SC19B,94.30%,96.40%,94.60%,93.70%,96.80%,96.60%,1628,8,16,13,0,37,131,429,217,9,786,1628,5,14,14,0,33,135,421,209,8,773
Fulton,SC20,97.90%,97.50%,93.60%,97.80%,97.60%,93.70%,2562,5,38,8,4,55,106,1464,368,26,1964,2562,5,36,8,4,53,107,1464,359,27,1957
Fulton,SC211,95.10%,95.50%,92.50%,93.00%,96.50%,93.30%,1828,8,39,15,0,62,98,820,294,0,1212,1828,7,30,21,0,58,98,818,280,0,1196
Fulton,SC212,92.00%,94.50%,90.70%,92.20%,95.50%,92.70%,4244,25,98,52,1,176,246,1688,594,9,2537,4244,20,80,49,1,150,253,1686,578,12,2529
Fulton,SC23A,96.80%,96.50%,92.30%,96.50%,97.30%,94.30%,3854,27,41,21,1,90,324,1119,632,10,2085,3854,20,31,22,0,73,322,1111,610,11,2054
Fulton,SC23B,91.00%,96.60%,91.50%,88.60%,97.00%,92.70%,557,5,6,11,0,22,52,169,111,2,334,557,4,5,13,0,22,49,163,101,2,315
Fulton,SC23C,97.10%,95.90%,91.30%,98.20%,97.10%,92.60%,2606,19,37,12,0,68,198,866,401,2,1467,2606,16,26,7,0,49,198,868,390,2,1458
Fulton,SC27,96.10%,96.30%,90.80%,97.00%,96.80%,95.00%,2361,15,28,19,0,62,148,724,470,0,1342,2361,8,24,14,0,46,151,719,456,0,1326
Fulton,SC29A,97.90%,95.50%,94.20%,97.40%,95.50%,95.50%,3154,17,45,12,0,74,266,946,555,9,1776,3154,13,44,14,0,71,270,935,520,9,1734
Fulton,SC30A,100.00%,91.30%,76.90%,100.00%,95.70%,75.00%,157,1,4,0,2,7,3,42,62,7,114,157,1,2,0,2,5,4,44,59,5,112
Fulton,SC30B,97.50%,97.10%,88.30%,96.00%,97.00%,95.00%,1110,7,11,4,0,22,53,366,156,0,575,1110,3,11,6,0,20,57,356,143,0,556
Fulton,SS01,61.90%,41.60%,24.00%,55.00%,37.90%,17.90%,4846,235,1310,491,2,2038,71,933,799,4,1807,4846,255,1386,570,2,2213,52,847,696,4,1599
Fulton,SS02A,69.90%,59.90%,56.90%,65.30%,56.00%,50.00%,1206,28,214,89,0,331,32,320,207,5,564,1206,33,234,100,0,367,28,298,188,5,519
Fulton,SS02B,80.90%,74.70%,56.50%,77.40%,74.20%,58.00%,1318,34,145,49,3,231,44,429,207,4,684,1318,31,145,57,3,236,44,416,195,3,658
Fulton,SS03,72.50%,59.00%,40.30%,67.80%,55.10%,35.50%,1577,68,306,96,3,473,47,440,253,1,741,1577,75,336,109,3,523,42,412,230,1,685
Fulton,SS04,73.00%,66.30%,53.10%,69.80%,65.40%,50.50%,3763,134,536,216,9,895,150,1053,584,12,1799,3763,137,544,230,9,920,136,1029,532,13,1710
Fulton,SS05,67.50%,52.90%,28.70%,60.80%,48.80%,25.20%,1853,93,431,164,4,692,38,484,341,1,864,1853,100,470,197,4,771,34,448,306,1,789
Fulton,SS06,66.20%,50.70%,49.30%,58.30%,47.00%,42.50%,1667,51,401,147,26,625,38,413,288,37,776,1667,57,429,181,27,694,29,381,253,33,696
Fulton,SS07A,54.90%,52.60%,40.40%,47.40%,48.10%,32.70%,1254,30,268,172,1,471,21,297,209,0,527,1254,35,291,195,0,521,17,270,176,0,463
Fulton,SS07B,67.80%,64.40%,64.30%,64.00%,62.00%,59.60%,793,20,117,58,0,195,35,212,122,1,370,793,23,123,62,0,208,33,201,110,1,345
Fulton,SS07C,65.10%,48.40%,57.10%,61.20%,44.20%,51.00%,809,16,128,81,5,230,16,120,151,12,299,809,18,140,85,6,249,14,111,134,11,270
Fulton,SS08A,77.60%,72.30%,53.20%,75.90%,71.90%,53.50%,1891,85,223,64,9,381,99,582,222,8,911,1891,85,226,66,8,385,100,577,208,7,892
Fulton,SS08B,66.00%,48.60%,51.50%,59.60%,47.20%,43.80%,696,16,168,68,0,252,17,159,132,0,308,696,18,168,78,0,264,14,150,115,0,279
Fulton,SS08C,77.60%,68.20%,45.00%,78.10%,68.30%,41.50%,716,22,93,37,0,152,18,199,128,0,345,716,24,92,35,0,151,17,198,125,0,340
Fulton,SS08D,75.70%,69.20%,55.40%,73.10%,66.30%,53.50%,1555,45,191,74,0,310,56,430,231,0,717,1555,47,208,79,0,334,54,409,215,0,678
Fulton,SS09A,63.10%,45.70%,28.00%,54.80%,40.50%,24.40%,3193,167,756,350,0,1273,65,637,598,0,1300,3193,170,831,420,0,1421,55,566,509,0,1130
Fulton,SS09B,64.90%,47.60%,32.20%,57.70%,42.60%,30.10%,3611,121,928,347,3,1399,57,844,642,2,1545,3611,124,1012,411,4,1551,54,751,560,1,1366
Fulton,SS11A,69.90%,64.90%,59.70%,65.30%,62.70%,56.70%,4026,138,563,230,5,936,204,1040,533,8,1785,4026,152,596,257,4,1009,195,1003,484,9,1691
Fulton,SS11B,82.30%,69.80%,72.40%,81.70%,69.00%,72.60%,1412,34,158,43,0,235,88,366,200,1,655,1412,34,162,42,0,238,89,361,187,1,638
Fulton,SS11C,84.80%,82.50%,82.90%,86.70%,82.80%,84.80%,361,6,22,5,0,33,28,104,28,1,161,361,5,22,4,0,31,27,106,26,1,160
Fulton,SS11D,70.90%,49.70%,22.20%,62.00%,47.60%,21.40%,397,21,94,30,0,145,6,93,73,0,172,397,22,98,38,0,158,6,89,62,0,157
Fulton,SS12,66.30%,55.90%,40.40%,57.30%,51.50%,33.80%,2897,116,565,256,5,942,76,716,504,6,1302,2897,128,615,318,5,1066,63,652,426,5,1146
Fulton,SS13A,68.20%,53.30%,48.60%,62.30%,49.20%,48.30%,2103,90,432,128,3,653,85,493,274,3,855,2103,87,469,149,3,708,81,454,246,3,784
Fulton,SS13B,72.40%,56.10%,54.70%,67.00%,53.20%,55.80%,1278,43,271,54,0,368,51,347,142,1,541,1278,42,289,63,0,394,52,328,128,1,509
Fulton,SS14,60.10%,38.40%,19.60%,49.10%,31.90%,11.10%,1412,77,457,130,1,665,19,285,196,0,500,1412,87,505,162,1,755,11,237,156,0,404
Fulton,SS15A,88.00%,85.40%,76.20%,88.30%,85.20%,76.20%,2756,66,134,37,1,238,211,786,272,4,1273,2756,65,134,34,1,234,207,770,256,4,1237
Fulton,SS15B,75.50%,69.30%,58.90%,71.70%,68.50%,59.00%,1730,86,198,60,0,344,122,448,185,1,756,1730,83,199,68,1,351,120,433,172,1,726
Fulton,SS16,67.30%,46.00%,24.80%,58.90%,39.60%,23.30%,2116,93,532,204,4,833,29,453,420,3,905,2116,94,597,250,5,946,28,391,358,2,779
Fulton,SS17,62.90%,51.40%,45.40%,58.10%,48.70%,40.40%,3686,191,757,299,6,1253,155,801,506,9,1471,3686,207,791,330,5,1333,136,752,457,8,1353
Fulton,SS18A,67.60%,51.40%,27.50%,63.80%,46.90%,17.60%,657,37,151,59,0,247,14,160,123,0,297,657,42,164,64,0,270,9,145,113,0,267
Fulton,SS18B,63.60%,47.40%,17.60%,63.90%,43.90%,16.70%,241,13,61,24,1,99,2,55,42,1,100,241,14,64,22,1,101,2,50,39,1,92
Fulton,SS19A,81.00%,74.50%,70.00%,77.60%,74.30%,68.20%,3299,60,335,92,7,494,149,981,393,7,1530,3299,60,333,104,7,504,137,965,361,7,1470
Fulton,SS19B,79.10%,72.60%,67.70%,73.10%,71.50%,65.80%,2342,49,278,84,32,443,93,735,317,77,1222,2342,52,285,105,31,473,88,716,285,72,1161
Fulton,SS20,79.40%,66.50%,67.20%,74.20%,65.80%,67.90%,2404,63,295,87,4,449,128,586,336,9,1059,2404,59,300,108,4,471,125,576,311,8,1020
Fulton,SS22,65.70%,59.40%,54.80%,63.70%,57.40%,54.70%,2834,101,374,214,2,691,121,547,410,4,1082,2834,101,390,213,0,704,118,526,374,4,1022
Fulton,SS26,83.70%,82.30%,80.90%,80.40%,83.10%,81.00%,3824,51,254,73,4,382,223,1183,375,10,1791,3824,47,236,82,5,370,210,1163,336,11,1720
Fulton,SS29A,70.60%,65.30%,42.60%,65.80%,62.00%,40.20%,2842,127,418,179,5,729,96,788,430,2,1316,2842,129,452,204,5,790,89,739,392,1,1221
Fulton,SS31,71.40%,56.40%,49.50%,65.10%,55.10%,47.40%,1703,50,336,118,0,504,49,434,294,0,777,1703,51,343,140,0,534,46,421,261,0,728
Fulton,UC01A,94.80%,94.80%,90.10%,95.80%,95.50%,93.40%,4234,33,66,19,2,120,306,1194,347,12,1859,4234,23,55,14,0,92,311,1178,322,13,1824
Fulton,UC01B,100.00%,95.20%,88.50%,100.00%,95.80%,94.10%,428,4,7,0,2,13,42,139,31,4,216,428,1,6,0,2,9,45,138,29,3,215
Fulton,UC01E,92.00%,96.70%,90.90%,94.40%,96.70%,95.20%,512,4,9,6,0,19,40,265,69,0,374,512,2,9,4,0,15,40,265,68,0,373
Fulton,UC02A,95.40%,96.10%,89.60%,96.20%,96.50%,92.80%,5609,34,88,56,3,181,303,2177,1151,17,3648,5609,22,77,43,3,145,307,2151,1103,15,3576
Fulton,UC02B,100.00%,71.40%,66.70%,100.00%,71.40%,100.00%,32,1,4,0,0,5,2,10,3,0,15,32,0,4,0,0,4,2,10,3,0,15
Fulton,UC02C,87.50%,93.80%,87.50%,92.70%,93.90%,90.90%,3614,21,80,18,0,119,135,1220,126,12,1493,3614,15,78,10,0,103,136,1195,127,13,1471
Fulton,UC031,75.40%,86.60%,84.50%,75.20%,86.80%,85.10%,2745,29,98,135,3,265,150,635,413,25,1223,2745,26,95,128,4,253,150,627,389,21,1187
Fulton,UC032,83.20%,89.80%,76.00%,80.00%,89.70%,76.90%,393,6,15,16,0,37,18,132,79,1,230,393,6,15,18,0,39,19,131,72,1,223
Gilmer,1,44.60%,15.90%,12.70%,43.40%,15.60%,13.20%,3172,368,1091,302,2,1763,54,207,243,0,504,3172,360,1074,288,2,1724,55,199,221,0,475
Gilmer,2,33.30%,11.40%,5.30%,30.20%,11.20%,4.50%,1598,409,472,172,2,1055,23,61,86,0,170,1598,400,467,173,2,1042,19,59,75,0,153
Gilmer,3,27.30%,12.20%,10.20%,26.50%,13.00%,9.60%,1782,442,461,133,0,1036,50,64,50,0,164,1782,432,443,125,0,1000,46,66,45,0,157
Gilmer,4,36.60%,8.40%,10.50%,36.30%,7.60%,12.30%,1234,308,326,92,0,726,36,30,53,0,119,1234,291,326,86,0,703,41,27,49,0,117
Gilmer,5,35.40%,16.40%,8.10%,33.00%,16.50%,9.30%,2939,532,910,303,3,1748,47,179,166,0,392,2939,515,892,293,2,1702,52,176,144,1,373
Gilmer,6,39.90%,23.40%,14.50%,34.60%,22.90%,13.70%,926,248,210,98,0,556,42,64,65,0,171,926,246,209,104,0,559,39,62,55,0,156
Gilmer,7,42.80%,12.70%,10.00%,37.60%,12.10%,10.20%,1391,295,481,158,3,937,33,70,118,0,221,1391,288,480,164,3,935,33,66,99,0,198
Gilmer,8,28.80%,15.60%,9.90%,28.10%,16.00%,10.70%,1139,263,342,109,1,715,29,63,44,0,136,1139,258,337,105,1,701,31,64,41,0,136
Gilmer,9,28.60%,15.40%,15.80%,23.60%,14.50%,12.00%,1655,230,593,190,0,1013,43,108,76,0,227,1655,235,596,194,0,1025,32,101,60,0,193
Gilmer,10,27.60%,17.20%,8.10%,28.50%,15.40%,7.40%,1810,294,571,184,1,1050,26,119,70,0,215,1810,287,567,171,1,1026,23,103,68,0,194
Gilmer,11,36.30%,11.80%,7.90%,35.40%,11.40%,6.30%,1288,359,345,107,0,811,31,46,61,0,138,1288,354,341,104,0,799,24,44,57,0,125
Gilmer,12,43.20%,14.30%,6.70%,39.80%,13.90%,7.20%,1479,374,396,147,0,917,27,66,112,0,205,1479,360,389,148,0,897,28,63,98,0,189
Gilmer,13,40.10%,16.60%,4.60%,38.90%,15.40%,4.70%,1851,249,665,188,0,1102,12,132,126,0,270,1851,245,666,182,0,1093,12,121,116,0,249
Glascock,EDGH,15.40%,16.10%,0.00%,15.40%,16.70%,0.00%,136,51,47,11,0,109,0,9,2,0,11,136,51,45,11,0,107,0,9,2,0,11
Glascock,GIBS,24.40%,6.60%,14.50%,21.30%,5.70%,14.90%,677,106,271,65,0,442,18,19,21,0,58,677,103,263,59,0,425,18,16,16,0,50
Glascock,MILL,16.90%,4.80%,4.50%,18.30%,5.20%,5.90%,778,147,338,69,0,554,7,17,14,0,38,778,144,331,67,0,542,9,18,15,0,42
Glascock,MITC,21.10%,10.90%,13.20%,21.60%,10.50%,13.30%,448,99,139,60,0,298,15,17,16,0,48,448,98,136,58,0,292,15,16,16,0,47
Glynn,1713,43.00%,19.20%,20.30%,41.50%,19.20%,19.60%,4578,409,1503,365,3,2280,104,356,275,1,736,4578,401,1486,361,2,2250,97,353,256,1,707
Glynn,1923,52.70%,24.50%,16.00%,50.20%,24.10%,17.50%,3460,414,1104,205,2,1725,77,358,228,2,665,3460,394,1085,204,2,1685,83,344,206,1,634
Glynn,1933,51.90%,24.90%,22.50%,50.10%,24.40%,20.10%,2824,306,913,208,0,1427,89,302,224,0,615,2824,311,909,208,0,1428,78,293,209,0,580
Glynn,1943,32.20%,15.10%,17.10%,29.60%,14.90%,17.10%,2529,264,973,223,2,1462,55,173,106,0,334,2529,255,956,214,2,1427,53,168,90,0,311
Glynn,2713,47.90%,26.90%,20.20%,43.70%,24.60%,20.60%,3699,274,1395,417,3,2089,69,514,383,1,967,3699,263,1424,436,3,2126,68,465,338,1,872
Glynn,2923,52.00%,22.50%,13.60%,46.00%,20.00%,13.00%,2823,214,1143,306,2,1665,34,331,332,0,697,2823,213,1180,337,2,1732,32,295,287,0,614
Glynn,2933,53.10%,26.20%,17.40%,48.20%,24.70%,15.90%,4333,275,1725,398,1,2399,57,613,451,1,1122,4333,280,1758,416,1,2455,52,576,387,1,1016
Glynn,2943,49.20%,26.60%,24.90%,45.70%,25.00%,24.20%,4316,275,1608,429,0,2312,89,583,416,2,1090,4316,272,1626,449,0,2347,85,543,378,2,1008
Glynn,2953,69.00%,44.80%,27.10%,66.00%,43.60%,26.90%,774,200,79,62,2,343,75,64,138,0,277,774,196,79,66,2,343,73,61,128,0,262
Glynn,3713,51.40%,29.50%,23.90%,52.60%,29.10%,24.30%,3925,386,1094,242,3,1725,122,457,256,0,835,3925,371,1079,218,3,1671,119,442,242,1,804
Glynn,3723,47.70%,25.40%,26.00%,44.90%,25.60%,26.80%,2109,212,571,124,1,908,74,194,113,1,382,2109,207,558,125,1,891,75,192,102,1,370
Glynn,3733,45.40%,25.30%,20.50%,41.80%,24.50%,22.10%,2960,300,854,255,3,1412,78,289,212,0,579,2960,294,846,253,2,1395,84,275,182,0,541
Glynn,3743,53.20%,26.90%,21.20%,52.40%,25.90%,18.80%,3288,310,966,251,3,1530,83,356,285,1,725,3288,312,967,245,3,1527,72,338,270,1,681
Glynn,4913,42.90%,30.60%,39.40%,42.50%,30.40%,39.60%,3286,192,820,272,5,1289,127,362,204,1,694,3286,191,806,262,4,1263,127,352,194,1,674
Glynn,4923,70.10%,58.20%,51.40%,69.40%,56.90%,53.50%,3313,187,431,168,1,787,198,601,393,1,1193,3313,173,440,162,0,775,198,582,368,1,1149
Glynn,4933,70.00%,54.00%,48.20%,69.10%,53.10%,44.70%,2971,132,411,144,1,688,123,483,336,1,943,2971,139,407,141,1,688,113,461,316,0,890
Glynn,5913,71.70%,55.20%,59.10%,71.10%,54.50%,59.10%,2367,96,338,119,0,553,137,416,302,2,857,2367,95,332,116,0,543,135,397,285,2,819
Glynn,5923,76.40%,61.80%,53.70%,75.30%,61.30%,53.80%,3320,154,362,122,1,639,177,585,395,3,1160,3320,149,354,123,1,627,173,561,374,2,1110
Glynn,5933,91.30%,89.40%,84.90%,90.40%,88.70%,83.10%,3638,53,86,49,1,189,301,723,517,2,1543,3638,59,89,50,0,198,287,696,473,3,1459
Glynn,5943,85.40%,64.30%,64.00%,85.50%,62.70%,64.30%,1439,48,116,29,1,194,84,209,169,3,465,1439,45,116,27,1,189,80,195,159,3,437
Gordon,1054,31.90%,10.20%,6.60%,28.70%,10.10%,6.30%,1471,436,360,94,1,891,31,41,44,0,116,1471,427,356,92,1,876,29,40,37,0,106
Gordon,1055,35.10%,12.80%,10.00%,34.90%,12.40%,10.60%,2044,528,456,131,3,1118,59,67,71,0,197,2044,519,454,125,3,1101,62,64,67,0,193
Gordon,1056,29.80%,10.80%,9.80%,28.00%,10.80%,10.30%,5380,1145,1711,388,2,3246,125,207,165,0,497,5380,1118,1691,375,2,3186,129,204,146,0,479
Gordon,1063,38.50%,9.40%,5.80%,37.40%,9.20%,5.90%,1071,324,261,59,0,644,20,27,37,0,84,1071,318,257,57,0,632,20,26,34,0,80
Gordon,1064,33.30%,20.40%,11.70%,30.90%,21.00%,11.30%,667,218,117,68,0,403,29,30,34,0,93,667,213,113,67,0,393,27,30,30,0,87
Gordon,1235,33.60%,13.30%,6.50%,32.30%,13.50%,6.30%,1439,444,255,91,0,790,31,39,46,0,116,1439,433,244,84,0,761,29,38,40,0,107
Gordon,849-A,33.60%,16.30%,15.80%,31.80%,16.20%,16.50%,6423,843,1910,471,3,3227,159,372,238,0,769,6423,816,1877,459,1,3153,161,363,214,0,738
Gordon,849-B,46.00%,23.60%,26.10%,43.30%,23.10%,26.80%,9532,947,2634,651,1,4233,333,814,554,1,1702,9532,920,2600,651,1,4172,337,779,497,0,1613
Gordon,856,35.50%,11.70%,10.70%,36.10%,11.10%,10.90%,1914,358,590,149,0,1097,43,78,82,0,203,1914,353,578,140,0,1071,43,72,79,0,194
Gordon,874,24.30%,9.20%,7.70%,24.40%,9.70%,7.30%,1991,686,356,171,2,1215,57,36,55,0,148,1991,668,346,158,2,1174,53,37,51,0,141
Gordon,973,39.80%,14.70%,10.50%,37.20%,14.30%,11.30%,2965,658,891,153,1,1703,77,154,101,0,332,2965,637,881,155,1,1674,81,147,92,0,320
Gordon,980,24.80%,13.60%,8.90%,25.00%,13.20%,9.20%,1532,399,325,112,2,838,39,51,37,0,127,1532,392,316,108,2,818,40,48,36,0,124
Grady,B,34.30%,15.20%,13.90%,41.20%,15.30%,14.80%,916,176,290,44,3,513,25,52,23,4,104,916,171,287,40,2,500,26,52,28,4,110
Grady,C04,82.30%,79.90%,82.50%,81.00%,77.90%,80.20%,2532,43,178,77,0,298,200,708,358,3,1269,2532,48,193,80,0,321,191,680,340,3,1214
Grady,C05,53.50%,39.10%,42.70%,49.00%,38.40%,41.50%,2606,160,645,180,0,985,115,414,207,4,740,2606,161,644,185,1,991,112,401,178,3,694
Grady,D,59.60%,30.00%,13.00%,61.90%,28.40%,12.00%,470,80,126,36,0,242,12,54,53,0,119,470,81,126,32,0,239,11,50,52,0,113
Grady,H,47.80%,28.80%,25.60%,47.50%,28.80%,25.20%,854,177,158,83,0,418,61,64,76,0,201,854,175,156,83,0,414,59,63,75,0,197
Grady,L,50.00%,14.40%,6.30%,43.20%,15.30%,3.20%,320,60,113,23,0,196,4,19,23,0,46,320,60,111,25,0,196,2,20,19,0,41
Grady,M,36.70%,20.40%,16.90%,37.60%,20.30%,15.50%,1412,195,429,138,2,764,40,110,80,0,230,1412,199,424,128,2,753,37,108,77,0,222
Grady,P,42.90%,30.50%,26.80%,44.10%,30.10%,26.90%,1003,159,239,64,2,464,59,105,48,0,212,1003,156,237,57,2,452,58,102,45,0,205
Grady,R,47.70%,29.90%,11.80%,47.70%,29.50%,12.80%,475,105,110,46,0,261,14,47,42,0,103,475,102,110,45,0,257,15,46,41,0,102
Grady,S,26.30%,9.30%,7.50%,26.70%,10.40%,7.10%,758,209,194,70,0,473,17,20,25,0,62,758,210,189,66,0,465,16,22,24,0,62
Grady,SH,34.70%,10.00%,4.70%,36.10%,9.70%,4.90%,561,121,206,47,0,374,6,23,25,0,54,561,117,205,46,0,368,6,22,26,0,54
Grady,W,37.50%,23.60%,14.90%,33.10%,24.10%,16.80%,1226,228,317,95,0,640,40,98,57,0,195,1226,218,311,91,0,620,44,99,45,0,188
Grady,WL,32.20%,14.20%,11.80%,31.10%,12.90%,12.40%,2309,315,891,200,0,1406,42,147,95,0,284,2309,304,894,195,0,1393,43,132,88,0,263
Greene,1,72.10%,45.70%,56.30%,70.50%,44.40%,54.80%,3999,161,926,200,0,1287,201,778,516,6,1501,3999,164,945,202,1,1312,195,755,482,5,1437
Greene,4,67.60%,44.00%,53.50%,67.60%,43.20%,52.80%,1873,138,368,108,0,614,159,289,225,0,673,1873,137,369,103,0,609,153,281,215,0,649
Greene,5,69.30%,38.70%,63.30%,69.30%,38.90%,59.40%,991,61,223,54,0,338,105,141,122,0,368,991,67,218,51,0,336,98,139,115,0,352
Greene,6,56.40%,40.80%,54.00%,49.10%,40.00%,54.00%,347,29,87,24,0,140,34,60,31,0,125,347,29,87,27,0,143,34,58,26,0,118
Greene,8,41.80%,17.30%,15.80%,36.60%,14.80%,12.30%,6961,455,3343,889,2,4689,84,697,638,2,1421,6961,467,3438,940,2,4847,64,599,542,2,1207
Gwinnett,1,64.40%,50.40%,47.00%,63.60%,50.50%,48.00%,7182,370,1542,490,3,2405,326,1564,887,5,2782,7182,359,1524,488,2,2373,327,1554,854,6,2741
Gwinnett,2,79.80%,82.70%,71.50%,79.70%,82.90%,72.90%,3987,104,270,165,0,539,260,1290,651,1,2202,3987,96,264,159,1,520,261,1277,626,0,2164
Gwinnett,3,72.90%,54.60%,50.60%,71.80%,54.30%,50.20%,4777,241,917,232,1,1391,247,1104,624,1,1976,4777,241,914,236,1,1392,243,1086,602,1,1932
Gwinnett,4,61.10%,56.30%,43.20%,59.10%,55.10%,45.10%,1737,120,296,132,1,549,92,381,207,0,680,1737,118,297,133,0,548,96,364,192,1,653
Gwinnett,5,57.70%,48.80%,36.50%,54.20%,47.80%,34.00%,2720,237,538,287,0,1062,136,513,392,0,1041,2720,247,546,307,0,1100,127,500,364,0,991
Gwinnett,6,71.50%,58.70%,45.20%,70.80%,58.30%,47.60%,3921,312,564,224,1,1101,257,801,563,1,1622,3921,292,559,223,1,1075,265,783,542,1,1591
Gwinnett,7,71.60%,56.20%,47.90%,68.40%,54.20%,47.50%,5042,236,845,397,1,1479,217,1084,999,1,2301,5042,238,876,433,1,1548,215,1035,939,1,2190
Gwinnett,8,53.30%,33.80%,28.20%,50.10%,32.30%,26.50%,4729,346,1518,460,2,2326,137,774,524,0,1435,4729,356,1538,479,1,2374,129,735,481,0,1345
Gwinnett,9,47.30%,30.90%,33.10%,42.90%,29.60%,35.80%,5692,308,1937,605,1,2851,153,866,543,0,1562,5692,288,1962,642,1,2893,161,823,483,0,1467
Gwinnett,10,50.10%,43.00%,37.00%,46.90%,42.20%,38.80%,2387,171,476,301,1,949,100,359,302,1,762,2387,170,470,310,0,950,107,343,274,1,725
Gwinnett,11,74.00%,64.50%,60.60%,73.00%,64.20%,60.70%,2555,175,237,117,0,529,267,431,333,2,1033,2555,169,238,117,0,524,259,427,316,2,1004
Gwinnett,12,73.60%,72.20%,66.50%,73.40%,72.70%,69.60%,5338,143,540,321,4,1008,287,1401,896,5,2589,5338,127,521,316,3,967,293,1389,870,5,2557
Gwinnett,13,54.30%,32.10%,24.80%,48.50%,29.70%,20.00%,3040,311,988,270,1,1570,103,467,321,0,891,3040,331,1011,296,1,1639,83,428,279,0,790
Gwinnett,14,57.60%,50.20%,40.00%,53.50%,47.60%,40.00%,3520,202,739,378,2,1321,135,746,514,1,1396,3520,203,775,409,1,1388,135,703,471,1,1310
Gwinnett,15,61.90%,55.60%,59.40%,60.20%,55.90%,59.30%,3635,169,506,266,0,941,242,633,433,5,1313,3635,161,492,264,0,917,231,624,399,4,1258
Gwinnett,16,72.80%,70.20%,57.80%,71.80%,70.40%,61.70%,5097,146,633,274,3,1056,203,1489,735,1,2428,5097,132,619,274,1,1026,211,1469,697,3,2380
Gwinnett,17,77.30%,75.80%,69.20%,77.60%,76.80%,70.90%,3303,143,246,124,3,516,324,770,423,4,1521,3303,129,232,119,3,483,319,768,413,2,1502
Gwinnett,18,67.60%,66.10%,66.30%,66.20%,65.30%,70.80%,3001,138,337,179,0,654,270,656,373,2,1301,3001,115,338,180,0,633,278,636,353,1,1268
Gwinnett,19,66.20%,61.30%,55.80%,64.10%,61.00%,58.90%,2549,177,320,184,1,682,220,506,361,5,1092,2549,164,316,188,1,669,231,494,335,5,1065
Gwinnett,20,82.10%,79.60%,71.50%,79.40%,80.70%,72.60%,2791,128,154,77,3,362,323,601,354,5,1283,2791,118,143,84,3,348,315,598,324,5,1242
Gwinnett,21,74.30%,74.10%,69.20%,73.20%,75.80%,69.70%,3485,129,264,136,3,532,292,757,394,4,1447,3485,121,240,138,4,503,283,751,376,4,1414
Gwinnett,22,63.60%,56.40%,36.00%,58.30%,54.30%,31.10%,2082,237,271,232,1,741,130,350,405,4,889,2082,249,283,260,1,793,109,336,364,4,813
Gwinnett,23,72.80%,75.10%,73.60%,72.30%,76.00%,76.40%,2264,94,149,82,2,327,264,449,219,3,935,2264,79,139,80,2,300,259,439,209,3,910
Gwinnett,24,59.20%,43.50%,37.90%,56.40%,42.60%,37.40%,4654,405,860,331,2,1598,245,661,480,3,1389,4654,401,854,342,2,1599,240,633,443,1,1317
Gwinnett,25,60.00%,45.00%,36.20%,59.60%,43.80%,35.10%,5596,504,1162,408,13,2087,288,950,611,5,1854,5596,500,1164,392,13,2069,273,908,579,5,1765
Gwinnett,26,69.90%,60.30%,52.00%,67.60%,60.00%,52.20%,5011,308,727,290,1,1326,334,1102,673,1,2110,5011,304,727,304,1,1336,332,1091,635,1,2059
Gwinnett,27,60.70%,42.40%,31.50%,60.30%,42.70%,33.20%,4583,391,1063,426,3,1883,179,782,659,2,1622,4583,376,1041,418,3,1838,186,776,635,2,1599
Gwinnett,28,63.60%,45.00%,39.10%,62.30%,44.00%,38.60%,5939,454,1441,382,0,2277,288,1180,667,4,2139,5939,450,1450,389,0,2289,279,1141,642,4,2066
Gwinnett,29,54.60%,43.30%,34.80%,51.20%,41.70%,35.80%,1587,145,319,174,1,639,77,244,209,1,531,1587,139,320,181,1,641,77,229,190,1,497
Gwinnett,30,69.30%,71.80%,51.20%,68.30%,71.40%,53.40%,2903,168,309,193,1,671,174,785,436,3,1398,2903,159,310,191,1,661,180,774,412,3,1369
Gwinnett,31,61.90%,42.80%,35.80%,59.50%,41.30%,36.70%,3179,272,670,249,1,1192,151,502,404,1,1058,3179,261,674,258,0,1193,150,475,379,1,1005
Gwinnett,32,65.80%,57.30%,45.50%,63.30%,55.80%,41.60%,2945,140,469,282,4,895,117,630,543,3,1293,2945,149,484,298,1,932,104,610,515,3,1232
Gwinnett,33,61.40%,45.80%,36.00%,60.30%,44.30%,33.80%,1997,155,442,192,0,789,86,374,306,1,767,1997,159,451,193,0,803,80,359,293,1,733
Gwinnett,34,64.90%,63.10%,51.30%,64.60%,63.30%,54.40%,2254,173,222,169,0,564,181,379,312,1,873,2254,161,216,166,0,543,191,372,303,1,867
Gwinnett,35,66.30%,57.50%,44.20%,64.90%,57.10%,44.20%,3755,234,624,309,0,1167,183,843,609,2,1637,3755,227,617,310,0,1154,178,822,574,2,1576
Gwinnett,36,64.40%,53.20%,42.00%,60.70%,52.70%,40.90%,2942,213,542,285,1,1041,154,617,515,1,1287,2942,213,542,310,1,1066,147,603,479,1,1230
Gwinnett,37,83.20%,82.30%,68.20%,82.00%,83.70%,68.00%,2184,113,105,57,2,277,240,487,283,7,1017,2184,110,94,58,2,264,232,482,264,6,984
Gwinnett,38,75.10%,68.50%,67.40%,75.80%,67.40%,67.10%,2546,116,221,113,2,452,242,480,341,2,1065,2546,114,224,105,1,444,233,463,328,2,1026
Gwinnett,39,52.70%,32.20%,32.50%,50.00%,31.30%,32.10%,7153,607,2087,690,3,3387,294,991,769,0,2054,7153,603,2094,701,3,3401,286,956,702,0,1944
Gwinnett,40,66.00%,55.70%,41.70%,63.70%,55.10%,39.70%,4536,332,721,431,1,1485,235,906,836,3,1980,4536,340,720,452,0,1512,221,884,793,3,1901
Gwinnett,41,74.50%,73.30%,62.20%,74.70%,73.50%,62.70%,5969,260,638,278,3,1179,426,1751,814,7,2998,5969,251,625,266,3,1145,420,1734,784,7,2945
Gwinnett,42,56.10%,44.50%,33.20%,55.20%,43.80%,33.00%,3037,288,615,271,0,1174,142,493,346,1,982,3037,282,608,274,0,1164,138,474,338,1,951
Gwinnett,43,74.40%,77.70%,71.20%,75.30%,78.60%,73.30%,2402,104,131,102,5,342,268,457,297,1,1023,2402,96,125,95,2,318,267,459,290,2,1018
Gwinnett,44,79.10%,77.80%,67.00%,78.90%,77.90%,69.00%,4177,146,331,164,1,642,298,1163,620,1,2082,4177,134,324,162,1,621,299,1142,605,1,2047
Gwinnett,45,68.80%,68.20%,62.30%,68.00%,68.70%,62.30%,3178,114,399,224,5,742,196,857,495,1,1549,3178,113,389,220,5,727,194,855,467,1,1517
Gwinnett,46,52.40%,48.50%,33.50%,50.20%,48.80%,34.50%,1787,207,318,224,1,750,104,300,247,1,652,1787,203,311,230,0,744,106,296,232,1,635
Gwinnett,47,56.10%,46.00%,38.30%,52.80%,44.20%,37.80%,2875,201,657,351,0,1209,125,559,449,0,1133,2875,201,671,365,0,1237,122,531,409,0,1062
Gwinnett,48,62.20%,49.50%,44.60%,61.10%,49.20%,42.70%,3551,247,543,352,3,1145,198,533,578,3,1312,3551,255,542,349,3,1149,190,524,549,2,1265
Gwinnett,49,67.60%,60.90%,47.90%,65.60%,60.30%,48.10%,2030,134,294,131,1,560,124,458,273,0,855,2030,134,294,135,0,563,123,446,258,1,828
Gwinnett,50,72.10%,75.00%,68.50%,71.50%,74.20%,70.20%,2635,115,192,127,0,434,249,576,328,1,1154,2635,106,196,124,0,426,248,563,311,2,1124
Gwinnett,51,82.30%,83.60%,77.90%,79.90%,83.50%,78.60%,2613,77,127,61,0,265,268,646,283,3,1200,2613,72,125,65,0,262,263,632,259,2,1156
Gwinnett,52,59.30%,53.50%,41.60%,58.60%,52.30%,37.40%,2419,159,488,228,1,876,113,562,332,1,1008,2419,164,495,223,0,882,97,542,316,1,956
Gwinnett,53,73.00%,70.40%,72.50%,72.50%,69.80%,74.70%,3924,115,405,190,0,710,301,961,515,2,1779,3924,105,403,184,0,692,309,931,484,1,1725
Gwinnett,54,56.40%,39.80%,28.80%,54.10%,38.20%,27.90%,5085,578,1215,431,1,2225,234,803,558,0,1595,5085,579,1227,437,1,2244,224,760,515,0,1499
Gwinnett,55,58.90%,40.00%,39.00%,59.00%,39.30%,39.30%,4624,311,1153,327,5,1796,200,768,469,2,1439,4624,300,1155,308,6,1769,196,748,443,2,1389
Gwinnett,56,65.70%,55.80%,44.30%,61.60%,53.60%,41.70%,2229,189,307,182,2,680,150,387,348,2,887,2229,193,319,200,1,713,138,369,321,1,829
Gwinnett,57,70.50%,61.40%,56.10%,69.60%,61.50%,57.20%,5077,237,663,296,8,1204,302,1056,707,11,2076,5077,225,650,291,8,1174,299,1037,666,12,2014
Gwinnett,58,80.00%,79.50%,71.20%,78.70%,78.60%,72.80%,3754,152,217,117,3,489,373,841,469,11,1694,3754,141,221,119,2,483,373,811,440,9,1633
Gwinnett,59,88.40%,83.00%,79.20%,88.80%,82.40%,81.20%,3819,120,196,66,1,383,457,955,505,5,1922,3819,107,201,61,0,369,456,938,482,6,1882
Gwinnett,60,73.70%,80.90%,73.10%,73.70%,80.50%,72.90%,5012,160,264,192,5,621,439,1116,537,9,2101,5012,159,261,186,4,610,430,1080,521,8,2039
Gwinnett,61,56.30%,50.80%,47.60%,54.70%,49.70%,50.30%,2355,164,384,244,1,793,149,396,314,1,860,2355,155,389,248,1,793,156,385,299,2,842
Gwinnett,62,55.20%,41.50%,29.30%,50.00%,39.30%,24.60%,2330,280,411,398,0,1089,115,291,491,1,898,2330,299,426,441,1,1167,98,276,441,0,815
Gwinnett,63,57.40%,37.40%,26.90%,50.30%,34.30%,20.40%,2673,307,605,353,0,1265,113,361,476,0,950,2673,340,633,412,0,1385,87,331,417,0,835
Gwinnett,64,77.20%,77.80%,74.10%,76.30%,77.60%,74.90%,3490,86,265,186,0,537,246,931,630,0,1807,3490,80,264,188,0,532,239,915,605,0,1759
Gwinnett,65,63.70%,66.00%,56.80%,62.70%,66.40%,59.00%,1987,115,181,149,2,447,151,352,262,3,768,1987,105,176,147,2,430,151,348,247,3,749
Gwinnett,66,77.00%,75.90%,71.70%,76.70%,75.60%,76.10%,3359,114,255,110,1,480,285,802,368,6,1461,3359,95,254,106,0,455,296,789,349,7,1441
Gwinnett,67,63.60%,52.80%,43.70%,62.40%,51.90%,47.00%,5660,307,1040,406,1,1754,236,1164,709,3,2112,5660,283,1048,405,0,1736,248,1130,671,3,2052
Gwinnett,68,66.20%,59.50%,42.70%,64.90%,58.20%,42.70%,3537,257,571,294,1,1123,191,839,575,1,1606,3537,259,589,298,1,1147,193,820,551,1,1565
Gwinnett,69,68.20%,65.20%,43.90%,65.30%,64.50%,45.00%,3478,242,439,269,3,953,189,824,576,3,1592,3478,231,445,282,2,960,188,809,531,3,1531
Gwinnett,70,64.70%,43.30%,41.30%,62.70%,41.60%,40.00%,3960,306,861,310,1,1478,216,658,569,0,1443,3960,307,880,320,1,1508,205,628,538,0,1371
Gwinnett,71,79.30%,76.80%,64.00%,80.30%,77.20%,63.30%,4061,170,351,160,0,681,298,1162,613,4,2077,4061,169,341,146,0,656,288,1154,594,4,2040
Gwinnett,72,88.30%,86.70%,79.30%,88.70%,86.90%,80.30%,6193,157,221,95,1,474,600,1440,719,7,2766,6193,144,213,87,1,445,586,1413,682,6,2687
Gwinnett,73,65.20%,59.90%,51.10%,58.90%,60.00%,50.10%,2185,175,261,212,1,649,183,390,398,1,972,2185,180,259,244,0,683,179,388,350,2,919
Gwinnett,74,85.40%,86.10%,76.80%,84.00%,87.50%,79.30%,1915,80,70,39,3,192,275,435,229,0,939,1915,72,62,40,0,174,273,434,210,3,920
Gwinnett,75,84.40%,83.90%,67.20%,83.70%,84.10%,69.30%,5125,139,337,186,2,664,284,1757,1009,5,3055,5125,128,330,188,2,648,289,1744,967,5,3005
Gwinnett,76,76.40%,75.60%,73.30%,76.70%,75.70%,76.50%,3642,72,376,199,1,648,193,1165,643,7,2008,3642,64,372,191,0,627,200,1158,629,8,1995
Gwinnett,77,74.40%,67.70%,58.80%,73.50%,67.20%,57.30%,5804,296,600,321,0,1217,422,1255,931,1,2609,5804,300,604,322,0,1226,401,1235,894,1,2531
Gwinnett,78,61.00%,60.10%,49.80%,61.40%,59.30%,49.20%,3824,159,661,346,0,1166,157,997,542,1,1697,3824,156,660,334,0,1150,151,963,531,0,1645
Gwinnett,79,63.40%,53.90%,39.90%,59.70%,53.50%,37.70%,2810,248,491,229,2,970,166,575,397,0,1138,2810,242,484,250,3,979,148,557,371,0,1076
Gwinnett,80,72.50%,63.40%,52.90%,71.60%,63.20%,52.90%,6499,318,1035,354,3,1710,361,1791,934,0,3086,6499,317,1032,356,3,1708,359,1771,899,0,3029
Gwinnett,81,65.50%,62.60%,53.90%,63.50%,62.00%,55.60%,4185,228,584,314,0,1126,264,977,596,3,1840,4185,215,585,320,0,1120,265,955,556,4,1780
Gwinnett,82,76.30%,69.50%,66.90%,75.20%,69.20%,66.20%,4814,207,515,240,3,965,419,1174,774,5,2372,4814,206,510,243,1,960,398,1148,737,8,2291
Gwinnett,83,65.20%,53.50%,45.80%,65.80%,53.20%,46.40%,4406,394,653,307,1,1355,330,750,574,4,1658,4406,386,645,294,1,1326,332,734,565,3,1634
Gwinnett,84,74.90%,71.70%,69.30%,75.50%,71.30%,67.20%,3046,114,306,142,1,563,259,774,423,1,1457,3046,118,305,134,1,558,243,756,413,1,1413
Gwinnett,85,64.40%,51.90%,42.80%,62.60%,51.20%,43.30%,4296,303,780,342,4,1429,228,843,619,2,1692,4296,292,778,353,3,1426,223,817,590,2,1632
Gwinnett,86,76.40%,74.80%,61.60%,75.90%,76.30%,62.70%,2570,147,163,108,3,421,237,485,350,4,1076,2570,138,150,103,2,393,231,483,325,4,1043
Gwinnett,87,67.00%,64.20%,65.40%,64.50%,63.70%,65.90%,3374,182,340,226,3,751,345,611,458,4,1418,3374,175,340,230,1,746,337,597,417,3,1354
Gwinnett,88,84.20%,78.00%,72.40%,83.90%,78.10%,75.50%,4638,147,330,142,1,620,386,1169,754,2,2311,4638,127,324,140,1,592,393,1155,727,2,2277
Gwinnett,89,59.00%,46.80%,32.20%,56.10%,46.50%,30.90%,3589,325,754,290,4,1373,154,664,418,2,1238,3589,324,746,305,3,1378,142,648,389,4,1183
Gwinnett,90,70.80%,63.90%,54.70%,68.70%,63.10%,57.00%,3312,217,370,186,1,774,261,655,450,2,1368,3312,200,376,193,1,770,264,643,423,2,1332
Gwinnett,91,65.90%,56.10%,39.50%,64.20%,55.70%,39.20%,4609,309,835,337,0,1481,201,1069,651,1,1922,4609,305,835,342,1,1483,197,1048,612,0,1857
Gwinnett,92,63.70%,50.30%,41.30%,59.90%,48.40%,41.80%,2731,160,563,265,2,990,112,570,466,2,1150,2731,160,580,287,0,1027,113,543,428,2,1086
Gwinnett,93,59.70%,49.70%,40.60%,56.20%,48.20%,38.50%,3988,255,851,426,1,1533,173,842,630,2,1647,3988,264,860,452,0,1576,163,799,580,2,1544
Gwinnett,94,46.70%,41.90%,36.20%,45.20%,40.70%,35.20%,2567,233,551,343,1,1128,133,397,301,0,831,2567,229,560,349,1,1139,125,384,288,0,797
Gwinnett,95,78.60%,77.90%,70.70%,78.10%,78.30%,71.90%,6161,195,403,265,5,868,467,1418,972,15,2872,6161,182,388,256,6,832,468,1403,912,14,2797
Gwinnett,96,59.80%,48.30%,37.60%,57.10%,47.20%,38.10%,3067,280,533,322,2,1137,168,497,479,2,1146,3067,269,538,338,2,1147,165,481,449,2,1097
Gwinnett,97,66.30%,55.30%,43.80%,65.30%,54.00%,45.50%,5491,421,845,415,1,1682,328,1046,815,1,2190,5491,406,863,407,1,1677,339,1014,765,1,2119
Gwinnett,98,69.50%,57.70%,48.80%,66.60%,57.60%,48.90%,3212,194,455,228,0,877,185,620,520,0,1325,3212,193,445,242,0,880,185,605,483,0,1273
Gwinnett,99,63.20%,63.50%,52.70%,62.50%,64.20%,54.50%,3201,208,334,257,3,802,232,581,441,3,1257,3201,198,325,253,2,778,236,582,422,4,1244
Gwinnett,100,61.40%,49.00%,35.60%,59.50%,47.60%,33.80%,4656,240,1073,411,1,1725,133,1030,655,0,1818,4656,245,1097,419,0,1761,125,996,615,0,1736
Gwinnett,101,70.10%,66.80%,55.00%,67.40%,66.70%,55.20%,2090,193,203,132,0,528,231,409,310,5,955,2090,193,202,142,0,537,233,404,293,5,935
Gwinnett,102,56.60%,38.10%,28.50%,53.90%,36.60%,28.50%,3096,295,855,240,1,1391,118,526,313,0,957,3096,283,863,247,1,1394,113,499,289,0,901
Gwinnett,103,73.80%,74.30%,70.80%,74.90%,73.60%,69.50%,3265,146,245,160,0,551,353,709,451,1,1514,3265,150,249,146,0,545,341,695,435,1,1472
Gwinnett,104,80.50%,83.10%,77.20%,80.40%,83.50%,79.30%,5795,89,442,215,1,747,299,2176,890,5,3370,5795,78,425,206,1,710,298,2148,843,5,3294
Gwinnett,105,61.70%,42.90%,35.90%,59.60%,42.20%,35.20%,4112,387,850,322,9,1568,220,638,519,2,1379,4112,383,837,330,5,1555,208,611,487,3,1309
Gwinnett,106,66.30%,49.60%,40.70%,63.90%,47.80%,39.50%,5675,334,1048,471,6,1859,231,1030,927,2,2190,5675,332,1069,486,6,1893,220,980,862,1,2063
Gwinnett,107,65.40%,53.20%,37.00%,59.90%,53.10%,37.00%,1434,167,232,119,3,521,98,264,225,2,589,1434,162,232,137,3,534,95,263,205,2,565
Gwinnett,108,68.40%,63.10%,54.10%,69.90%,62.30%,53.50%,3265,193,442,202,2,839,228,757,438,2,1425,3265,192,444,183,0,819,218,734,424,3,1379
Gwinnett,109,61.10%,50.70%,41.40%,57.60%,49.40%,37.30%,1864,162,330,177,2,671,115,340,278,1,734,1864,173,336,190,2,701,104,328,258,0,690
Gwinnett,110,74.90%,72.00%,65.00%,74.70%,72.20%,64.60%,2425,138,199,98,2,437,258,512,293,2,1065,2425,137,193,96,0,426,249,500,284,1,1034
Gwinnett,111,65.60%,51.10%,49.70%,63.20%,50.30%,47.00%,2813,157,455,279,3,894,155,476,533,3,1167,2813,164,456,287,3,910,146,462,493,2,1103
Gwinnett,112,62.40%,47.00%,44.50%,58.00%,46.20%,43.10%,3128,115,732,321,1,1169,93,650,532,0,1275,3128,114,736,358,1,1209,87,631,495,0,1213
Gwinnett,113,66.20%,63.60%,49.10%,66.80%,62.60%,54.70%,1706,117,196,107,0,420,111,342,210,2,665,1706,101,199,102,0,402,120,333,205,2,660
Gwinnett,114,64.20%,62.20%,55.20%,59.20%,60.90%,55.40%,4253,235,490,342,2,1069,286,807,612,6,1711,4253,224,505,382,1,1112,273,786,554,6,1619
Gwinnett,115,65.80%,66.60%,59.10%,66.80%,67.30%,61.40%,5037,269,533,364,5,1171,387,1065,700,9,2161,5037,244,514,339,6,1103,391,1059,681,7,2138
Gwinnett,116,69.30%,70.20%,66.70%,69.70%,70.80%,69.50%,4078,175,353,234,4,766,357,831,529,2,1719,4078,157,341,225,3,726,362,825,518,3,1708
Gwinnett,117,81.70%,80.20%,74.60%,82.70%,80.50%,73.70%,3923,154,237,117,6,514,464,957,521,6,1948,3923,154,229,107,4,494,437,943,510,5,1895
Gwinnett,118,65.00%,51.10%,50.40%,65.80%,50.60%,52.00%,1796,112,345,146,1,604,113,360,271,2,746,1796,106,342,136,1,585,114,350,262,2,728
Gwinnett,119,57.20%,46.50%,41.50%,54.90%,45.80%,42.40%,2589,182,510,292,0,984,126,443,391,3,963,2589,175,508,306,0,989,126,429,372,3,930
Gwinnett,120,71.90%,61.10%,58.50%,68.90%,61.90%,55.70%,1476,92,155,73,1,321,130,243,187,1,561,1476,97,149,78,1,325,122,242,173,1,538
Gwinnett,121,65.50%,54.00%,46.10%,63.10%,52.90%,46.40%,3412,221,550,352,7,1130,184,645,669,11,1509,3412,217,557,372,6,1152,181,626,635,12,1454
Gwinnett,122,84.10%,83.10%,73.40%,83.20%,83.10%,74.50%,5799,141,384,184,3,712,384,1884,970,13,3251,5799,132,379,189,3,703,382,1865,933,12,3192
Gwinnett,123,79.80%,79.70%,77.00%,81.70%,79.40%,78.20%,3272,109,171,90,1,371,367,670,355,1,1393,3272,102,170,77,0,349,363,656,343,2,1364
Gwinnett,124,81.00%,68.90%,64.00%,79.10%,68.40%,64.10%,2661,142,268,89,3,502,256,594,379,2,1231,2661,139,271,93,3,506,252,586,351,2,1191
Gwinnett,125,59.40%,39.70%,30.40%,52.10%,37.20%,24.10%,1898,270,345,258,0,873,118,227,377,0,722,1898,290,362,304,0,956,92,214,330,0,636
Gwinnett,126,57.50%,42.40%,26.80%,51.40%,38.70%,22.40%,2694,295,536,397,0,1228,108,395,538,0,1041,2694,309,575,455,0,1339,89,363,482,0,934
Gwinnett,127,75.60%,71.80%,56.10%,75.50%,71.40%,54.80%,2249,150,219,98,0,467,189,558,304,3,1054,2249,151,217,94,0,462,180,543,290,3,1016
Gwinnett,128,70.10%,54.90%,44.20%,66.40%,54.30%,45.00%,2796,211,464,175,0,850,166,565,411,1,1143,2796,198,463,193,0,854,160,551,381,2,1094
Gwinnett,129,53.30%,33.30%,28.70%,49.80%,32.00%,29.10%,5387,556,1619,462,4,2641,223,808,527,2,1560,5387,547,1633,483,4,2667,224,769,480,2,1475
Gwinnett,130,58.10%,38.40%,30.00%,54.40%,36.80%,27.90%,4732,425,1241,483,1,2150,181,774,670,2,1627,4732,438,1267,517,2,2224,169,737,616,1,1523
Gwinnett,131,58.60%,42.80%,29.60%,55.20%,40.90%,27.00%,4256,342,1067,423,0,1832,142,798,599,2,1541,4256,356,1090,451,1,1898,131,754,555,1,1441
Gwinnett,132,63.60%,53.10%,38.60%,61.20%,52.60%,39.90%,3282,275,579,285,0,1139,173,656,498,0,1327,3282,267,581,298,0,1146,177,646,471,0,1294
Gwinnett,133,58.30%,41.50%,36.60%,58.00%,41.00%,37.00%,4845,341,1259,316,3,1919,196,892,442,3,1533,4845,323,1247,310,2,1882,188,866,428,3,1485
Gwinnett,134,75.00%,71.70%,56.00%,74.10%,71.50%,56.70%,4608,230,541,228,4,1003,290,1371,684,8,2353,4608,222,541,227,4,994,289,1356,650,7,2302
Gwinnett,135,59.80%,37.60%,33.20%,59.50%,37.40%,31.70%,3367,261,887,235,0,1383,130,534,350,0,1014,3367,263,877,231,0,1371,122,525,339,0,986
Gwinnett,136,63.10%,43.70%,37.50%,63.20%,43.30%,38.00%,4292,341,917,308,0,1566,202,711,526,3,1442,4292,322,913,294,0,1529,194,696,504,3,1397
Gwinnett,137,59.80%,45.50%,39.30%,57.10%,44.30%,38.10%,5061,359,1193,357,2,1911,233,994,530,1,1758,5061,358,1208,368,2,1936,221,960,490,1,1672
Gwinnett,138,61.80%,46.40%,41.00%,59.30%,44.80%,40.80%,5105,297,918,609,1,1825,206,794,985,1,1986,5105,295,933,638,0,1866,202,757,928,1,1888
Gwinnett,139,76.90%,76.60%,68.60%,76.20%,77.60%,70.20%,5352,224,418,250,0,892,485,1369,832,4,2690,5352,205,392,248,0,845,479,1360,793,4,2636
Gwinnett,140,52.50%,34.70%,28.30%,47.30%,32.50%,25.30%,3785,319,1120,437,0,1876,125,594,483,1,1203,3785,322,1155,478,0,1955,108,555,429,1,1093
Gwinnett,141,61.70%,34.20%,22.10%,60.00%,33.10%,21.90%,2814,282,784,250,0,1316,79,408,403,1,891,2814,278,790,249,0,1317,77,391,373,1,842
Gwinnett,142,64.90%,50.00%,39.20%,63.50%,48.30%,36.70%,3966,276,775,322,2,1375,177,775,596,2,1550,3966,290,794,326,2,1412,167,741,568,2,1478
Gwinnett,143,70.40%,61.90%,56.10%,68.70%,61.50%,55.80%,4802,222,719,316,1,1258,284,1166,750,1,2201,4802,222,722,324,0,1268,279,1152,711,1,2143
Gwinnett,144,79.60%,78.20%,66.40%,78.90%,78.10%,69.90%,7255,264,574,273,3,1114,521,2059,1065,6,3651,7255,229,565,269,2,1065,530,2019,1006,6,3561
Gwinnett,145,76.10%,71.70%,54.80%,75.20%,71.40%,54.40%,6241,261,778,293,0,1332,315,1967,933,1,3216,6241,262,773,291,0,1326,312,1930,884,1,3127
Gwinnett,146,64.30%,56.70%,47.60%,63.50%,56.20%,48.30%,6811,365,1344,518,2,2229,330,1761,931,3,3025,6811,354,1347,510,2,2213,330,1726,887,3,2946
Gwinnett,147,69.40%,65.80%,55.00%,68.50%,66.00%,54.10%,5899,260,792,350,6,1408,321,1521,793,4,2639,5899,260,779,346,5,1390,306,1511,752,6,2575
Gwinnett,148,60.70%,49.80%,39.00%,61.30%,50.30%,41.20%,1802,163,303,159,1,626,104,301,246,1,652,1802,152,297,151,1,601,106,301,239,1,647
Gwinnett,149,59.40%,56.90%,39.40%,55.80%,55.50%,39.60%,2501,241,371,265,0,877,157,489,387,0,1033,2501,241,378,276,0,895,158,472,348,0,978
Gwinnett,150,81.10%,76.70%,76.20%,79.90%,76.90%,74.90%,2786,72,170,76,0,318,227,559,327,3,1116,2786,74,164,77,1,316,222,546,306,2,1076
Gwinnett,151,60.80%,50.80%,31.20%,58.40%,50.50%,30.00%,2850,380,600,178,2,1160,172,620,276,1,1069,2850,378,599,183,2,1162,162,611,257,1,1031
Gwinnett,152,62.60%,46.00%,41.50%,60.70%,44.60%,42.20%,4806,331,1167,338,0,1836,231,993,565,4,1793,4806,328,1181,348,0,1857,235,952,537,4,1728
Gwinnett,153,68.50%,61.00%,56.50%,65.60%,62.40%,56.20%,2573,167,302,140,0,609,210,472,305,7,994,2573,165,283,145,0,593,205,470,276,7,958
Gwinnett,154,56.30%,38.10%,35.90%,53.70%,37.50%,35.30%,3622,249,953,325,4,1531,141,587,418,1,1147,3622,249,957,334,4,1544,138,574,388,0,1100
Gwinnett,155,69.90%,55.40%,44.40%,67.00%,52.70%,44.80%,3904,286,697,250,0,1233,227,867,581,1,1676,3904,281,729,272,0,1282,227,811,551,1,1590
Gwinnett,156,73.20%,71.60%,60.50%,73.60%,71.50%,62.00%,4567,199,518,242,1,960,301,1308,660,5,2274,4567,191,511,230,0,932,306,1280,641,5,2232
Habersham,1,32.30%,12.90%,13.00%,29.40%,12.20%,13.10%,9096,642,4109,993,8,5752,95,606,474,2,1177,9096,621,4090,999,8,5718,94,567,417,1,1079
Habersham,2,31.90%,16.50%,22.70%,31.20%,15.70%,23.20%,6171,506,2153,602,6,3267,149,426,282,1,858,6171,486,2121,590,6,3203,148,395,267,1,811
Habersham,3,25.80%,11.00%,14.20%,26.00%,10.80%,14.20%,4963,483,2086,528,1,3098,79,258,184,1,522,4963,471,2058,497,1,3027,77,249,175,1,502
Habersham,4,32.60%,19.90%,17.20%,28.60%,19.80%,17.10%,790,99,238,64,2,403,21,59,31,0,111,790,95,235,65,2,397,20,58,26,0,104
Habersham,5,40.90%,21.50%,25.50%,35.70%,20.00%,21.80%,1252,140,295,88,0,523,48,81,61,0,190,1252,140,292,90,0,522,39,73,50,0,162
Habersham,6,26.80%,10.90%,15.10%,25.80%,11.10%,15.50%,4435,487,1638,459,4,2588,87,200,168,0,455,4435,471,1615,444,2,2532,87,202,154,0,443
Habersham,7,40.20%,15.40%,10.60%,39.40%,15.70%,9.50%,1557,271,564,171,0,1006,32,103,115,0,250,1557,267,553,166,0,986,28,103,108,0,239
Hall,1,41.70%,21.80%,33.50%,38.40%,20.30%,32.60%,0,338,1662,912,1,2913,170,463,653,1,1287,0,337,1674,929,0,2940,162,427,579,1,1169
Hall,2,55.60%,39.70%,46.90%,52.70%,39.60%,45.80%,0,225,769,224,1,1219,199,507,280,1,987,0,220,753,220,1,1194,186,493,245,1,925
Hall,3,48.00%,39.90%,38.70%,47.20%,40.10%,40.60%,0,231,564,183,0,978,146,375,169,0,690,0,221,549,177,0,947,151,368,158,0,677
Hall,4,35.60%,20.80%,18.60%,34.00%,20.10%,19.20%,0,409,1439,450,2,2300,94,377,249,0,720,0,401,1431,449,2,2283,96,360,231,0,687
Hall,5,40.60%,20.40%,17.80%,40.40%,19.40%,18.90%,0,442,1518,464,0,2424,95,388,317,1,801,0,428,1512,451,0,2391,99,364,306,1,770
Hall,6,48.90%,23.60%,21.80%,49.30%,23.90%,22.20%,0,393,1073,261,5,1732,111,332,250,0,693,0,381,1050,246,5,1682,110,329,239,0,678
Hall,7,38.40%,19.20%,19.80%,35.60%,18.20%,20.50%,0,500,1948,705,1,3154,124,462,439,0,1025,0,483,1957,698,1,3139,125,436,386,0,947
Hall,8,33.60%,15.70%,16.50%,33.20%,14.70%,16.20%,0,462,1589,368,0,2419,91,295,186,0,572,0,451,1574,358,0,2383,87,272,178,0,537
Hall,9,42.90%,24.70%,29.00%,40.20%,23.70%,29.70%,0,364,1586,447,1,2398,147,520,336,2,1005,0,348,1588,446,2,2384,148,492,300,0,940
Hall,10,42.20%,25.90%,31.10%,41.30%,25.20%,32.00%,0,505,1708,482,0,2695,228,598,352,0,1178,0,479,1702,470,0,2651,225,572,330,0,1127
Hall,11,58.00%,45.10%,47.40%,58.10%,44.30%,49.40%,0,424,1023,335,5,1787,387,839,462,0,1688,0,394,1018,315,5,1732,389,809,437,0,1635
Hall,12,41.70%,18.80%,21.60%,41.10%,18.40%,21.30%,0,360,1195,315,0,1870,96,276,225,3,600,0,351,1183,304,0,1838,92,266,212,3,573
Hall,13,31.10%,11.00%,12.00%,29.70%,11.20%,13.50%,0,556,1226,275,10,2067,77,152,124,0,353,0,532,1203,260,7,2002,83,151,110,1,345
Hall,14,22.70%,8.60%,6.20%,19.70%,7.80%,6.20%,0,421,1682,324,1,2428,28,158,95,0,281,0,420,1678,326,1,2425,28,141,80,0,249
Hall,15,25.00%,9.10%,10.10%,23.10%,8.60%,9.40%,0,230,1420,273,1,1924,25,142,91,1,259,0,229,1419,276,1,1925,23,133,83,1,240
Hall,16,34.70%,14.50%,15.90%,32.50%,14.20%,17.20%,0,464,2330,592,5,3391,89,396,314,0,799,0,456,2316,583,2,3357,95,383,281,0,759
Hall,17,38.60%,14.60%,17.40%,35.50%,14.30%,16.70%,0,464,1389,419,1,2273,97,237,263,1,598,0,458,1382,420,1,2261,91,231,231,1,554
Hall,18,37.90%,17.00%,13.90%,34.50%,16.30%,13.40%,0,516,1168,370,0,2054,81,240,226,2,549,0,511,1164,379,0,2054,77,226,200,2,505
Hall,19,38.00%,15.70%,20.60%,36.50%,15.00%,20.50%,0,369,1690,455,0,2514,96,315,279,0,690,0,348,1680,452,0,2480,90,296,260,0,646
Hall,20,38.60%,17.40%,17.90%,33.50%,16.20%,15.50%,0,324,1423,621,1,2369,71,300,390,0,761,0,332,1432,659,1,2424,61,276,332,0,669
Hall,21,46.50%,33.90%,33.40%,44.10%,32.50%,31.10%,0,326,930,432,3,1691,163,477,376,2,1018,0,333,934,429,4,1700,150,449,338,2,939
Hall,22,86.60%,82.50%,82.10%,85.00%,82.20%,82.90%,0,65,123,81,0,269,297,579,523,1,1400,0,60,122,85,0,267,290,563,480,1,1334
Hall,23,56.90%,48.00%,51.30%,56.40%,48.00%,52.00%,0,304,654,256,3,1217,323,603,338,0,1264,0,291,638,241,1,1171,316,590,312,0,1218
Hall,24,54.60%,39.90%,41.40%,51.50%,38.50%,39.70%,0,174,566,212,0,952,123,375,255,0,753,0,175,575,221,0,971,115,360,235,0,710
Hall,25,55.30%,32.80%,38.80%,52.30%,31.30%,35.90%,0,126,319,102,0,547,80,156,126,0,362,0,127,332,103,0,562,71,151,113,0,335
Hall,26,36.10%,13.70%,8.50%,33.60%,13.90%,11.20%,0,319,358,76,2,755,30,57,43,0,130,0,309,353,75,1,738,39,57,38,0,134
Hall,27,29.80%,9.70%,9.40%,26.10%,8.80%,8.50%,0,376,1818,407,1,2602,39,195,173,0,407,0,376,1827,416,1,2620,35,177,147,0,359
Hall,28,44.90%,18.90%,17.70%,40.40%,17.20%,17.50%,0,521,3388,1144,3,5056,113,790,931,0,1834,0,516,3426,1201,3,5146,110,711,813,0,1634
Hall,29,40.80%,22.20%,15.60%,39.30%,21.30%,15.40%,0,397,1171,255,2,1825,74,335,176,0,585,0,394,1163,252,2,1811,72,314,163,0,549
Hall,30,49.00%,21.60%,25.40%,44.90%,21.40%,27.10%,0,327,1742,319,2,2390,112,481,307,0,900,0,313,1727,331,2,2373,117,471,270,0,858
Hall,31,52.00%,25.80%,19.40%,48.50%,24.30%,20.60%,0,179,1528,246,4,1957,41,531,267,3,842,0,181,1539,258,4,1982,45,494,243,3,785
Hancock,1A,66.10%,37.20%,46.30%,63.80%,37.30%,46.90%,1006,87,235,86,0,408,74,139,168,1,382,1006,85,229,85,0,399,74,136,150,1,361
Hancock,1B,90.60%,77.30%,89.80%,90.00%,72.90%,89.50%,576,10,41,9,0,60,88,140,87,0,315,576,10,48,9,0,67,85,129,81,0,295
Hancock,2A,88.70%,66.90%,80.30%,88.60%,66.40%,78.20%,931,23,101,22,0,146,93,204,172,1,470,931,26,99,21,0,146,92,196,164,1,453
Hancock,2B,91.90%,83.10%,83.30%,93.80%,85.00%,77.50%,472,12,24,12,0,48,60,118,137,0,315,472,16,21,9,0,46,55,119,136,0,310
Hancock,3A,91.80%,79.70%,77.80%,90.90%,77.40%,73.50%,356,16,13,8,0,37,56,51,90,0,197,356,18,14,8,0,40,50,48,80,0,178
Hancock,3B,86.10%,71.50%,85.70%,84.40%,72.40%,81.70%,731,17,57,22,0,96,101,143,136,1,381,731,21,54,24,0,99,93,142,130,1,366
Hancock,3C,62.40%,32.00%,6.70%,60.50%,33.00%,10.00%,268,28,70,32,0,130,2,33,53,0,88,268,27,69,32,0,128,3,34,49,0,86
Hancock,4A,89.50%,79.00%,79.20%,89.00%,76.00%,78.00%,975,26,62,27,0,115,99,233,229,0,561,975,27,69,28,0,124,96,218,226,0,540
Hancock,4B,82.40%,63.10%,50.00%,78.00%,64.60%,51.20%,364,41,31,21,0,93,41,53,98,0,192,364,41,29,26,0,96,43,53,92,0,188
Hancock,4C,91.40%,75.00%,41.70%,90.90%,75.00%,38.50%,148,14,7,5,0,26,10,21,53,0,84,148,16,7,5,0,28,10,21,50,0,81
Haralson,2,34.00%,12.60%,12.60%,31.90%,12.50%,13.40%,6622,975,2251,572,0,3798,140,325,295,0,760,6622,947,2225,559,0,3731,146,318,262,0,726
Haralson,3,24.10%,9.00%,7.20%,23.80%,9.10%,8.10%,2365,401,830,220,1,1452,31,82,70,0,183,2365,387,808,205,1,1401,34,81,64,0,179
Haralson,4,15.30%,8.40%,7.00%,14.40%,8.60%,6.80%,1075,292,251,94,0,637,22,23,17,0,62,1075,287,245,89,0,621,21,23,15,0,59
Haralson,5,12.70%,8.30%,5.50%,13.70%,9.10%,7.50%,1682,394,511,145,0,1050,23,46,21,0,90,1682,382,499,139,0,1020,31,50,22,0,103
Haralson,6,24.20%,5.20%,5.20%,27.30%,6.50%,5.70%,738,221,200,72,0,493,12,11,23,0,46,738,217,186,64,0,467,13,13,24,0,50
Haralson,7,25.90%,2.60%,2.60%,28.00%,1.30%,4.30%,304,113,76,20,0,209,3,2,7,0,12,304,110,76,18,0,204,5,1,7,0,13
Haralson,8,20.00%,4.50%,4.30%,19.70%,4.60%,5.40%,699,267,169,64,0,500,12,8,16,0,36,699,261,167,61,0,489,15,8,15,0,38
Haralson,9,9.70%,6.80%,6.90%,7.10%,6.90%,7.00%,330,134,69,28,0,231,10,5,3,0,18,330,132,67,26,0,225,10,5,2,0,17
Haralson,10,31.30%,12.10%,5.60%,30.70%,11.80%,6.70%,1932,386,569,147,2,1104,23,78,67,0,168,1932,373,567,142,2,1084,27,76,63,0,166
Haralson,11,12.50%,12.80%,3.10%,16.40%,14.20%,4.00%,665,222,156,56,0,434,7,23,8,0,38,665,214,151,51,0,416,9,25,10,0,44
Haralson,12,29.20%,12.20%,10.00%,26.90%,12.40%,10.60%,3072,583,845,286,1,1715,65,117,118,0,300,3072,565,822,283,1,1671,67,116,104,0,287
Haralson,13,24.10%,8.00%,7.60%,28.40%,7.50%,8.30%,1183,329,297,82,0,708,27,26,26,0,79,1183,320,294,73,0,687,29,24,29,0,82
Harris,CA,46.60%,23.40%,15.00%,43.60%,22.20%,15.70%,2898,622,822,251,1,1696,110,251,219,0,580,2898,611,820,255,1,1687,114,234,197,0,545
Harris,EL,52.80%,28.80%,15.80%,51.60%,27.90%,15.60%,4211,818,1152,356,0,2326,153,467,398,0,1018,4211,814,1158,352,0,2324,151,449,376,0,976
Harris,GM,51.20%,29.80%,39.20%,49.50%,29.40%,37.50%,1649,251,340,139,0,730,161,144,146,1,452,1649,253,337,141,0,731,151,140,138,1,430
Harris,HA,59.90%,29.60%,26.90%,58.00%,29.50%,26.70%,2739,426,747,165,4,1342,157,314,246,1,718,2739,419,742,165,4,1330,154,311,228,0,693
Harris,L9,48.80%,20.00%,10.60%,45.20%,19.10%,11.00%,2570,645,690,219,2,1556,77,172,209,0,458,2570,644,691,222,2,1559,80,163,183,0,426
Harris,MG,37.60%,16.60%,9.60%,34.70%,16.50%,9.60%,2908,572,996,274,0,1842,61,198,165,0,424,2908,563,989,284,0,1836,60,195,151,0,406
Harris,PV,39.10%,17.60%,11.40%,38.00%,17.50%,11.80%,1121,408,216,78,2,704,52,46,50,1,149,1121,402,212,75,2,691,54,45,46,0,145
Harris,SK,55.90%,31.60%,31.50%,52.20%,29.90%,30.60%,894,250,108,71,0,429,113,50,90,2,255,894,250,110,77,0,437,108,47,84,2,241
Harris,U9,31.50%,14.00%,12.20%,29.10%,13.50%,12.90%,1628,424,508,148,2,1082,59,83,68,0,210,1628,418,508,151,2,1079,62,79,62,0,203
Harris,VP,53.80%,25.50%,23.10%,48.60%,24.80%,23.10%,785,253,114,55,0,422,76,39,64,0,179,785,249,112,57,0,418,75,37,54,0,166
Harris,WA,56.80%,29.00%,24.30%,53.50%,28.00%,24.50%,2853,521,639,230,2,1392,167,261,302,1,731,2853,513,643,238,2,1396,166,250,274,1,691
Harris,WH,52.10%,21.50%,18.60%,51.50%,20.00%,18.50%,1370,402,295,101,0,798,92,81,110,0,283,1370,391,300,100,0,791,89,75,106,0,270
Hart,2,48.10%,24.50%,29.80%,45.70%,23.50%,29.70%,6451,471,2211,575,1,3258,199,718,533,1,1451,6451,461,2200,569,0,3230,194,674,478,1,1347
Hart,3,34.00%,16.90%,15.80%,33.00%,16.00%,15.80%,1901,353,602,163,0,1118,65,122,84,1,272,1901,347,597,150,0,1094,64,114,74,1,253
Hart,4,62.00%,33.40%,38.50%,60.40%,31.50%,37.10%,1162,144,287,68,0,499,90,144,111,0,345,1162,146,292,65,0,503,86,134,99,0,319
Hart,5,39.60%,13.60%,14.20%,36.20%,12.90%,15.20%,2990,447,1166,298,1,1912,74,184,195,0,453,2990,434,1164,300,1,1899,78,173,170,0,421
Hart,6,34.70%,18.50%,12.30%,35.50%,17.30%,10.80%,1395,329,410,77,0,816,46,93,41,0,180,1395,330,415,71,0,816,40,87,39,0,166
Hart,7,33.30%,10.70%,10.40%,33.20%,10.10%,10.80%,1656,355,542,162,0,1059,41,65,81,0,187,1656,348,540,155,0,1043,42,61,77,0,180
Hart,8,46.90%,23.10%,15.80%,47.00%,22.30%,14.00%,1374,239,469,94,0,802,45,141,83,0,269,1374,240,463,89,0,792,39,133,79,0,251
Heard,CEN,25.60%,11.10%,12.70%,24.10%,11.20%,13.10%,1767,372,576,174,0,1122,54,72,60,0,186,1767,365,565,173,0,1103,55,71,55,0,181
Heard,COO,11.50%,6.70%,10.70%,10.20%,6.30%,10.50%,700,142,196,46,0,384,17,14,6,0,37,700,145,192,44,0,381,17,13,5,0,35
Heard,ENO,26.00%,12.80%,4.80%,22.20%,13.10%,5.90%,1156,276,294,74,0,644,14,43,26,0,83,1156,270,285,70,0,625,17,43,20,0,80
Heard,EPH,17.00%,10.10%,4.90%,17.60%,9.10%,5.20%,1321,424,301,127,0,852,21,34,26,1,82,1321,418,300,122,0,840,22,30,26,1,79
Heard,FRA,40.20%,17.00%,18.50%,38.90%,18.10%,18.60%,2178,264,676,198,1,1139,60,138,133,0,331,2178,258,651,193,1,1103,59,144,123,0,326
Heard,SOU,43.70%,21.40%,9.90%,43.80%,19.60%,12.40%,640,163,154,58,0,375,18,42,45,0,105,640,155,152,54,0,361,22,37,42,0,101
Henry,25,79.20%,65.90%,61.50%,79.10%,65.90%,61.50%,6978,216,1049,237,2,1504,347,2025,901,1,3274,6978,214,1037,228,2,1481,344,2007,864,1,3216
Henry,26,38.10%,13.60%,10.30%,37.80%,13.70%,12.20%,3409,557,1305,250,0,2112,64,205,154,0,423,3409,540,1291,242,0,2073,75,205,147,0,427
Henry,27,50.90%,22.40%,17.70%,51.00%,22.20%,18.80%,4875,616,1780,268,2,2666,130,515,278,3,926,4875,608,1755,262,2,2627,138,500,273,3,914
Henry,28,87.50%,83.90%,79.80%,87.70%,83.70%,80.70%,6971,137,320,138,0,595,535,1666,965,7,3173,6971,127,318,127,0,572,524,1629,903,7,3063
Henry,29,81.50%,65.00%,64.30%,80.90%,65.20%,66.30%,9878,297,1432,332,3,2064,537,2665,1461,3,4666,9878,279,1416,327,1,2023,546,2653,1384,4,4587
Henry,30,73.40%,49.10%,54.10%,73.60%,49.30%,54.70%,5476,217,1288,209,1,1715,256,1240,577,1,2074,5476,215,1267,196,1,1679,260,1232,547,1,2040
Henry,31,73.70%,56.80%,59.10%,73.60%,57.30%,60.70%,7156,233,1352,302,0,1887,334,1775,845,2,2956,7156,223,1315,290,0,1828,343,1768,809,2,2922
Henry,32,84.00%,80.10%,72.80%,83.90%,80.10%,74.90%,5335,109,504,169,0,782,290,2023,887,1,3201,5335,100,499,162,0,761,298,2013,844,1,3156
Henry,33,84.60%,86.00%,77.30%,84.30%,86.00%,78.30%,5610,100,360,158,0,618,339,2212,868,1,3420,5610,95,355,152,0,602,341,2188,816,1,3346
Henry,34,81.90%,77.50%,74.70%,82.20%,77.90%,77.50%,6144,137,590,188,1,916,402,2028,853,5,3288,6144,118,578,177,1,874,405,2032,815,5,3257
Henry,35,81.30%,71.90%,65.80%,80.50%,71.40%,66.80%,2838,94,329,99,0,522,175,841,429,6,1451,2838,89,332,99,0,520,173,830,409,6,1418
Henry,36,56.60%,31.80%,20.10%,56.10%,31.00%,21.10%,3719,481,1195,222,0,1898,121,558,290,0,969,3719,471,1201,217,0,1889,126,540,277,0,943
Henry,37,45.80%,28.00%,29.20%,43.20%,27.30%,27.20%,3389,243,1284,311,0,1838,100,500,263,0,863,3389,244,1285,313,0,1842,91,482,238,0,811
Henry,38,74.10%,66.20%,67.50%,72.00%,66.20%,68.50%,5122,145,826,250,0,1221,300,1618,717,1,2636,5122,139,817,261,0,1217,301,1603,670,1,2575
Henry,39,86.00%,85.10%,78.00%,85.50%,85.10%,77.80%,6541,104,379,181,3,667,377,2173,1110,2,3662,6541,102,373,179,4,658,370,2128,1052,1,3551
Henry,41,69.50%,57.40%,63.00%,69.20%,57.60%,64.30%,3546,117,645,168,1,931,198,870,382,3,1453,3546,108,632,158,1,899,194,860,355,2,1411
Henry,42,65.20%,59.60%,50.80%,65.30%,59.40%,51.70%,4785,190,899,233,2,1324,196,1324,436,2,1958,4785,181,890,225,1,1297,193,1303,424,2,1922
Henry,43,63.00%,47.30%,39.20%,61.50%,46.80%,40.80%,4135,196,1106,276,1,1579,122,992,470,5,1589,4135,188,1108,276,1,1573,126,973,441,4,1544
Henry,44,72.90%,68.70%,62.60%,72.70%,68.90%,63.50%,3374,79,537,157,0,773,129,1179,422,3,1733,3374,76,527,150,0,753,130,1170,399,2,1701
Henry,45,64.60%,43.70%,44.00%,63.60%,43.30%,46.00%,3642,197,909,193,0,1299,153,706,352,2,1213,3642,188,906,189,0,1283,158,691,330,2,1181
Henry,46,91.40%,88.20%,78.80%,90.60%,88.50%,82.60%,4047,63,220,64,0,347,232,1650,683,2,2567,4047,50,212,67,0,329,236,1639,649,2,2526
Henry,47,87.20%,84.20%,77.70%,86.90%,84.30%,77.60%,4275,51,325,115,0,491,177,1726,781,1,2685,4275,51,319,111,0,481,176,1718,737,1,2632
Henry,48,55.30%,27.90%,19.90%,54.70%,26.90%,19.90%,4850,421,1774,290,1,2486,104,686,359,1,1150,4850,413,1773,283,1,2470,102,654,342,1,1099
Henry,49,80.70%,69.20%,74.90%,78.20%,69.60%,74.20%,4077,106,472,123,1,702,311,1058,514,8,1891,4077,107,459,131,0,697,302,1049,470,6,1827
Henry,50,64.20%,59.30%,58.60%,62.80%,59.20%,58.40%,5214,135,870,407,4,1416,194,1268,729,3,2194,5214,133,861,405,3,1402,188,1248,683,3,2122
Henry,51,65.30%,52.90%,48.40%,65.10%,52.80%,51.30%,4508,220,947,292,1,1460,206,1062,550,1,1819,4508,206,939,280,1,1426,217,1049,522,1,1789
Henry,52,56.10%,39.00%,30.60%,54.10%,38.40%,30.30%,5049,398,1427,391,1,2217,175,913,500,1,1589,5049,388,1426,393,1,2208,168,890,464,1,1523
Henry,53,74.30%,72.10%,63.80%,72.90%,71.90%,64.00%,4430,105,575,267,1,948,187,1485,771,0,2443,4430,103,574,266,1,944,185,1469,717,0,2371
Henry,54,77.20%,74.00%,75.60%,76.50%,73.90%,77.90%,4416,84,441,153,1,679,262,1253,517,2,2034,4416,78,431,149,0,658,273,1218,485,2,1978
Henry,55,58.90%,38.90%,26.10%,57.00%,39.20%,26.50%,3452,342,1078,213,0,1633,121,685,305,0,1111,3452,335,1067,220,0,1622,121,688,292,0,1101
Henry,56,69.40%,65.60%,57.80%,69.00%,65.60%,58.80%,3693,128,587,203,0,918,175,1120,460,0,1755,3693,124,584,196,0,904,177,1114,436,0,1727
Henry,57,62.20%,49.10%,50.80%,61.50%,48.40%,52.10%,2751,129,605,213,0,947,131,584,351,2,1068,2751,123,602,208,0,933,132,565,332,2,1031
Henry,58,59.10%,27.30%,19.80%,56.40%,26.80%,19.50%,3535,627,1070,157,1,1855,155,402,227,0,784,3535,624,1068,159,1,1852,151,391,206,0,748
Henry,59,66.70%,40.90%,42.40%,66.70%,41.30%,42.50%,4079,258,1033,179,1,1471,190,714,358,1,1263,4079,257,1009,170,1,1437,190,710,340,1,1241
Henry,60,58.40%,47.10%,39.70%,59.60%,46.90%,38.80%,4260,278,1034,271,1,1584,183,919,380,1,1483,4260,280,1031,253,2,1566,179,909,374,0,1462
Henry,61,62.00%,59.30%,68.90%,60.30%,59.10%,70.10%,4250,94,757,315,0,1166,208,1105,515,0,1828,4250,88,749,318,0,1155,206,1084,484,0,1774
Henry,62,58.60%,41.70%,23.70%,56.20%,41.30%,24.10%,2096,239,575,140,2,956,75,411,198,0,684,2096,237,575,137,2,951,76,404,176,0,656
Houston,ANNX,51.10%,29.10%,27.90%,48.00%,28.40%,28.70%,4512,461,1182,532,5,2180,178,485,556,2,1221,4512,450,1190,557,4,2201,181,471,515,2,1169
Houston,BMS,52.50%,32.10%,23.50%,50.20%,31.60%,22.80%,9536,1323,2497,991,1,4812,405,1182,1096,2,2685,9536,1308,2505,1013,1,4827,384,1156,1021,2,2563
Houston,CENT,56.40%,39.80%,32.90%,55.30%,40.30%,32.70%,7795,912,1523,694,1,3130,444,1009,897,3,2353,7795,898,1496,686,2,3082,435,1010,847,2,2294
Houston,CGTC,56.30%,34.20%,25.20%,53.80%,33.40%,25.80%,4860,529,1301,402,4,2236,180,677,517,0,1374,4860,527,1309,410,4,2250,185,655,478,0,1318
Houston,FMMS,64.00%,44.00%,33.50%,62.50%,43.10%,33.40%,8767,1040,1819,579,1,3439,522,1429,1030,2,2983,8767,1035,1833,582,1,3451,518,1391,971,2,2882
Houston,HAFS,48.60%,19.40%,14.90%,46.70%,18.80%,14.40%,1805,618,353,112,0,1083,107,85,106,1,299,1805,613,349,112,0,1074,103,81,98,0,282
Houston,HCTC,61.60%,48.10%,45.30%,58.40%,47.80%,47.00%,6361,530,925,452,2,1909,436,857,725,4,2022,6361,499,914,468,2,1883,440,838,656,4,1938
Houston,HEFS,56.90%,24.60%,33.20%,53.50%,24.40%,32.10%,1372,332,255,84,4,675,162,83,111,5,361,1372,335,254,87,4,680,155,82,100,5,342
Houston,HHPC,62.60%,46.40%,50.10%,61.10%,45.70%,50.20%,9610,670,1441,707,3,2821,673,1249,1183,4,3109,9610,660,1433,705,3,2801,666,1207,1106,3,2982
Houston,MCMS,57.40%,35.80%,26.90%,54.90%,35.10%,26.60%,9181,1069,2405,721,8,4203,394,1343,973,3,2713,9181,1062,2412,745,8,4227,385,1302,907,2,2596
Houston,NSES,53.70%,34.40%,26.10%,53.30%,34.50%,26.60%,2441,385,491,243,1,1120,136,258,282,0,676,2441,375,487,232,1,1095,136,256,265,0,657
Houston,RECR,84.10%,74.20%,76.20%,82.40%,74.00%,76.20%,9277,310,503,268,6,1087,1004,1450,1415,9,3878,9277,306,494,280,3,1083,978,1409,1308,10,3705
Houston,ROZR,51.80%,30.10%,32.60%,49.50%,29.30%,32.70%,13802,1471,3661,1178,4,6314,709,1573,1267,5,3554,13802,1450,3675,1186,3,6314,699,1525,1161,6,3391
Houston,TMS,67.00%,56.50%,51.60%,65.70%,56.80%,52.60%,5286,429,704,355,5,1493,461,915,720,2,2098,5286,418,686,348,3,1455,465,903,666,3,2037
Houston,TWPK,54.70%,40.80%,30.00%,52.60%,40.60%,30.90%,4415,609,873,385,1,1868,258,601,465,4,1328,4415,602,861,384,1,1848,267,588,426,3,1284
Houston,VHS,53.30%,30.70%,22.60%,51.80%,30.00%,22.50%,6295,956,1744,460,4,3164,280,774,524,0,1578,6295,949,1747,457,4,3157,277,747,491,0,1515
Irwin,901,14.70%,6.80%,8.00%,13.10%,7.50%,10.50%,1796,301,708,151,0,1160,26,52,26,0,104,1796,291,695,153,0,1139,34,56,23,0,113
Irwin,1529,54.50%,27.40%,42.40%,51.70%,26.70%,44.20%,3642,238,1135,167,4,1544,177,429,200,1,807,3642,228,1125,171,3,1527,182,409,183,1,775
Irwin,1753,37.80%,13.80%,17.10%,38.00%,12.80%,17.90%,675,116,263,51,0,430,24,42,31,0,97,675,115,265,49,0,429,25,39,30,0,94
Jackson,1000,41.20%,16.70%,17.30%,39.50%,16.30%,17.10%,16263,1439,6545,1171,2,9157,301,1308,820,0,2429,16263,1409,6482,1152,2,9045,291,1265,751,0,2307
Jackson,2000,34.50%,14.80%,17.80%,33.30%,14.80%,17.20%,12699,1244,4523,1152,1,6920,270,786,608,0,1664,12699,1221,4468,1124,1,6814,254,774,562,0,1590
Jackson,3000,38.70%,14.80%,17.10%,36.20%,14.40%,17.50%,14977,1434,6433,1370,2,9239,296,1120,866,1,2283,14977,1396,6403,1359,2,9160,295,1079,771,1,2146
Jackson,4000,41.70%,18.00%,18.00%,40.30%,17.80%,18.10%,8012,844,2634,702,1,4181,186,577,503,0,1266,8012,841,2616,689,1,4147,186,567,466,0,1219
Jasper,290,47.30%,14.50%,15.30%,44.70%,14.20%,15.20%,1940,446,489,128,1,1064,80,83,115,1,279,1940,441,485,131,1,1058,78,80,106,1,265
Jasper,295,55.80%,26.90%,37.40%,54.30%,26.30%,37.50%,4516,273,1532,346,10,2161,168,565,437,1,1171,4516,265,1529,345,10,2149,165,546,410,0,1121
Jasper,296,27.70%,8.70%,5.30%,26.80%,8.50%,6.20%,3976,828,1434,334,1,2597,46,137,128,0,311,3976,797,1424,322,1,2544,53,133,118,0,304
Jeff Davis,100,63.00%,46.80%,47.90%,61.20%,45.10%,46.60%,1406,111,238,57,0,406,102,209,97,0,408,1406,110,240,57,0,407,96,197,90,0,383
Jeff Davis,201,24.60%,12.40%,9.70%,23.20%,13.00%,13.00%,703,93,311,43,0,447,10,44,14,0,68,703,87,302,43,0,432,13,45,13,0,71
Jeff Davis,202,13.50%,3.20%,4.10%,14.00%,3.20%,4.70%,1249,347,489,77,0,913,15,16,12,0,43,1249,341,482,74,0,897,17,16,12,0,45
Jeff Davis,301,46.20%,17.10%,20.30%,45.50%,17.80%,19.00%,870,102,237,42,0,381,26,49,36,0,111,870,98,226,42,0,366,23,49,35,0,107
Jeff Davis,302,15.40%,3.70%,2.20%,15.60%,4.60%,2.20%,722,177,261,55,0,493,4,10,10,0,24,722,174,250,54,0,478,4,12,10,0,26
Jeff Davis,401,37.00%,19.20%,24.30%,37.10%,19.70%,26.20%,988,103,332,68,0,503,33,79,40,0,152,988,96,323,66,0,485,34,79,39,0,152
Jeff Davis,402,15.50%,3.70%,5.80%,14.50%,5.20%,6.80%,642,196,206,49,0,451,12,8,9,0,29,642,191,201,47,0,439,14,11,8,0,33
Jeff Davis,501,20.80%,10.50%,17.10%,21.40%,10.70%,16.90%,1399,180,538,103,0,821,37,63,27,0,127,1399,177,525,99,0,801,36,63,27,0,126
Jeff Davis,502,45.20%,17.50%,7.60%,45.20%,18.50%,10.40%,499,109,137,34,0,280,9,29,28,0,66,499,103,132,34,0,269,12,30,28,0,70
Jefferson,76,72.20%,25.00%,31.70%,73.10%,25.00%,28.20%,441,68,99,20,1,188,32,33,52,0,117,441,73,99,18,1,191,28,33,49,1,111
Jefferson,77,48.80%,38.00%,17.90%,44.70%,38.90%,17.70%,621,187,93,41,1,322,41,57,39,0,137,621,185,91,42,1,319,40,58,34,0,132
Jefferson,81,73.80%,43.10%,55.40%,73.00%,43.30%,54.60%,2870,258,510,114,0,882,318,386,321,3,1028,2870,259,501,112,0,872,308,383,303,3,997
Jefferson,82,76.30%,49.70%,69.30%,73.80%,48.20%,69.20%,3899,119,817,142,0,1078,264,808,457,5,1534,3899,118,830,151,1,1100,264,771,425,3,1463
Jefferson,83,85.90%,55.00%,76.00%,87.30%,54.70%,74.20%,1906,78,242,51,0,371,247,296,311,0,854,1906,83,240,44,0,367,239,290,302,0,831
Jefferson,85,66.10%,45.30%,42.90%,60.30%,47.20%,44.60%,531,76,88,20,0,184,57,73,39,0,169,531,72,84,23,0,179,58,75,35,0,168
Jefferson,1460,53.40%,39.70%,32.20%,53.60%,39.00%,31.30%,678,158,88,34,0,280,75,58,39,0,172,678,160,89,32,0,281,73,57,37,0,167
Jefferson,1593,40.00%,17.90%,12.60%,38.90%,18.20%,10.50%,388,152,55,24,1,232,22,12,16,0,50,388,153,54,22,1,230,18,12,14,0,44
Jenkins,1,75.10%,51.60%,63.70%,73.30%,49.50%,63.80%,974,49,150,43,0,242,86,160,130,0,376,974,47,156,43,0,246,83,153,118,0,354
Jenkins,2,68.20%,46.30%,66.40%,66.50%,43.10%,66.10%,1039,42,195,55,0,292,83,168,118,0,369,1039,41,201,55,0,297,80,152,109,0,341
Jenkins,3,42.30%,17.80%,18.20%,40.40%,17.90%,20.20%,1021,136,327,82,3,548,31,71,60,0,162,1021,131,321,81,3,536,34,70,55,0,159
Jenkins,4,30.20%,13.60%,12.00%,30.00%,13.10%,10.90%,974,146,357,88,0,591,20,56,38,0,114,974,147,353,84,0,584,18,53,36,0,107
Jenkins,5,51.10%,32.20%,26.20%,48.90%,32.30%,23.90%,1058,206,215,67,0,488,72,102,70,1,245,1058,210,214,68,0,492,65,102,65,1,233
Johnson,1201,66.30%,34.50%,47.80%,62.90%,33.90%,47.40%,3113,133,951,167,0,1251,122,502,328,0,952,3113,131,930,172,0,1233,118,477,292,0,887
Johnson,1266,18.80%,6.70%,12.00%,18.50%,7.60%,12.30%,796,228,238,56,0,522,31,17,13,0,61,796,221,232,53,0,506,31,19,12,0,62
Johnson,1301,55.90%,17.60%,20.40%,50.50%,18.20%,20.70%,790,144,267,49,0,460,37,57,62,0,156,790,142,265,53,0,460,37,59,54,0,150
Johnson,55,22.40%,5.50%,6.70%,21.60%,6.30%,8.50%,912,266,292,59,0,617,19,17,17,0,53,912,260,284,58,0,602,24,19,16,0,59
Jones,1,45.60%,20.50%,15.80%,43.50%,20.00%,15.30%,0,250,1115,210,0,1575,47,288,176,0,511,0,249,1104,209,0,1562,45,276,161,0,482
Jones,10,81.60%,57.40%,43.40%,79.60%,56.10%,43.70%,0,253,500,115,0,868,194,674,509,0,1377,0,245,509,124,0,878,190,650,484,0,1324
Jones,11,56.30%,28.90%,30.60%,55.10%,28.50%,29.10%,0,175,533,115,0,823,77,217,148,0,442,0,175,528,110,0,813,72,210,135,0,417
Jones,2,47.70%,22.50%,17.70%,46.40%,22.30%,19.70%,0,292,850,173,1,1316,62,247,158,1,468,0,276,836,173,2,1287,68,240,150,0,458
Jones,3,52.30%,32.80%,22.30%,50.40%,33.60%,23.60%,0,449,581,174,0,1204,129,284,191,0,604,0,435,562,170,0,1167,133,284,173,1,591
Jones,4,36.30%,15.40%,10.30%,36.30%,15.60%,10.90%,0,363,494,102,1,960,42,90,58,0,190,0,351,477,100,1,929,43,88,57,0,188
Jones,5,57.60%,27.20%,28.00%,56.00%,26.80%,26.80%,0,307,515,98,1,921,119,192,133,1,445,0,303,508,99,0,910,110,186,126,1,423
Jones,6,50.30%,23.70%,19.20%,49.20%,22.60%,20.80%,0,274,374,94,0,742,65,116,95,0,276,0,266,377,93,0,736,70,110,90,0,270
Jones,8,38.90%,27.80%,16.50%,41.20%,29.40%,16.80%,0,91,13,11,0,115,18,5,7,0,30,0,89,12,10,0,111,18,5,7,0,30
Jones,9,54.30%,26.00%,13.40%,48.20%,25.10%,13.20%,0,569,691,180,1,1441,88,243,214,0,545,0,565,696,199,1,1461,86,233,185,0,504
Lamar,1711,80.50%,62.70%,60.10%,79.20%,61.50%,61.80%,2546,112,279,91,0,482,168,468,376,1,1013,2546,105,282,94,0,481,169,451,359,1,980
Lamar,1712A,50.30%,12.50%,8.10%,47.30%,13.10%,9.00%,1577,305,572,97,1,975,27,82,98,0,207,1577,301,566,98,1,966,30,85,88,0,203
Lamar,1712B,56.40%,28.70%,36.50%,55.40%,28.50%,37.00%,1337,128,362,79,1,570,74,146,102,0,322,1337,125,361,79,1,566,74,144,98,0,316
Lamar,1712C,45.90%,15.40%,8.20%,38.10%,14.10%,10.00%,623,190,159,40,0,389,17,29,34,0,80,623,181,158,39,0,378,20,26,24,0,70
Lamar,1713,44.10%,18.70%,17.30%,43.70%,18.00%,15.70%,2808,325,1006,210,5,1546,68,231,166,1,466,2808,323,1008,200,5,1536,60,221,155,1,437
Lamar,1714,35.60%,15.10%,14.80%,34.80%,14.40%,14.90%,3948,683,1394,290,1,2368,118,248,160,1,527,3948,678,1387,287,1,2353,118,233,153,1,505
Lanier,1,54.40%,22.50%,29.80%,52.00%,21.70%,28.50%,5462,481,1778,250,0,2509,204,517,298,0,1019,5462,469,1764,248,0,2481,187,488,269,0,944
Laurens,3,47.00%,33.40%,34.80%,44.80%,32.50%,34.40%,4180,336,1127,449,0,1912,178,565,398,1,1142,4180,334,1139,447,0,1920,174,548,363,1,1086
Laurens,4,80.60%,69.20%,75.00%,79.50%,66.90%,70.70%,6053,181,457,211,0,849,543,1028,876,0,2447,6053,205,474,213,0,892,494,958,824,0,2276
Laurens,5,39.20%,24.90%,19.30%,38.80%,24.30%,21.00%,3672,527,1203,360,0,2090,126,398,232,0,756,3672,509,1204,342,0,2055,135,387,217,0,739
Laurens,7,69.10%,47.00%,28.90%,70.70%,44.50%,29.20%,1047,214,124,59,0,397,86,110,132,1,329,1047,209,127,55,0,391,86,102,133,0,321
Laurens,8,46.10%,22.40%,11.40%,47.90%,22.40%,11.10%,422,163,45,41,0,249,21,13,35,0,69,422,160,45,37,0,242,20,13,34,0,67
Laurens,10,27.50%,19.10%,8.90%,25.40%,17.10%,10.10%,749,305,123,50,1,479,30,29,19,0,78,749,294,126,50,1,471,33,26,17,0,76
Laurens,11,38.90%,21.30%,14.20%,38.80%,22.50%,13.60%,1739,466,343,116,1,926,77,93,74,0,244,1739,462,335,115,1,913,73,97,73,0,243
Laurens,12,41.50%,16.30%,10.60%,40.50%,16.20%,10.50%,1121,355,313,93,0,761,42,61,66,0,169,1121,351,311,91,0,753,41,60,62,0,163
Laurens,13,28.40%,11.50%,11.30%,28.90%,10.70%,11.30%,1772,657,369,141,0,1167,84,48,56,0,188,1772,652,369,138,0,1159,83,44,56,0,183
Laurens,14,57.90%,48.00%,35.90%,53.60%,45.90%,35.30%,406,98,39,24,0,161,55,36,33,0,124,406,97,40,26,0,163,53,34,30,0,117
Laurens,15,15.70%,5.60%,4.30%,15.20%,6.20%,4.30%,937,355,185,91,1,632,16,11,17,0,44,937,352,182,89,1,624,16,12,16,0,44
Laurens,16,43.00%,22.70%,18.30%,42.60%,22.30%,17.50%,2344,497,527,175,0,1199,111,155,132,0,398,2344,491,517,170,0,1178,104,148,126,0,378
Laurens,18,51.70%,26.70%,20.60%,52.80%,25.80%,20.60%,2090,386,611,168,0,1165,99,223,180,1,503,2090,381,606,159,0,1146,98,211,178,1,488
Laurens,19,38.80%,20.20%,8.90%,37.70%,23.40%,10.00%,894,400,134,49,0,583,39,34,31,0,104,894,387,128,48,0,563,43,39,29,0,111
Laurens,21,62.00%,46.00%,38.90%,60.70%,44.80%,37.40%,3374,406,464,170,0,1040,259,395,277,0,931,3374,403,460,169,0,1032,241,373,261,0,875
Laurens,22,53.50%,37.80%,27.30%,54.90%,37.20%,27.10%,2080,314,415,154,0,883,118,252,177,0,547,2080,309,409,143,0,861,115,242,174,0,531
Lee,1,79.60%,33.60%,31.70%,79.10%,33.90%,33.60%,475,86,83,20,0,189,40,42,78,0,160,475,83,82,19,0,184,42,42,72,0,156
Lee,10,44.10%,17.30%,16.50%,43.10%,16.90%,16.70%,4841,703,1772,272,2,2749,138,371,215,1,725,4841,684,1759,261,2,2706,137,358,198,1,694
Lee,2,61.80%,27.30%,48.40%,61.70%,28.60%,48.60%,998,115,250,42,0,407,108,94,68,0,270,998,111,240,41,0,392,105,96,66,0,267
Lee,3,35.40%,12.90%,6.50%,36.20%,12.90%,5.90%,614,130,264,31,0,425,9,39,17,0,65,614,128,263,30,0,421,8,39,17,0,64
Lee,4,51.70%,27.30%,25.90%,50.40%,27.00%,26.00%,3313,377,1038,142,1,1558,132,390,152,0,674,3313,364,1032,137,1,1534,128,381,139,0,648
Lee,5,35.80%,17.60%,11.20%,35.30%,17.80%,12.60%,1376,223,515,70,0,808,28,110,39,0,177,1376,216,516,66,0,798,31,112,36,0,179
Lee,6,52.90%,27.00%,22.60%,50.60%,26.30%,22.00%,3921,510,1395,247,0,2152,148,515,277,1,941,3921,504,1397,249,0,2150,141,498,255,1,895
Lee,7,46.80%,23.50%,16.30%,44.70%,24.20%,18.30%,1576,272,544,100,0,916,53,167,88,0,308,1576,267,536,99,0,902,60,171,80,0,311
Lee,8,52.00%,22.30%,22.40%,52.30%,22.50%,22.20%,2621,326,875,107,0,1308,94,251,116,0,461,2621,326,866,103,0,1295,93,251,113,0,457
Lee,9,50.40%,30.70%,31.70%,49.70%,30.20%,31.90%,3162,312,992,190,1,1495,145,439,193,0,777,3162,306,990,183,1,1480,144,428,181,0,753
Liberty,1,91.10%,74.60%,76.50%,90.50%,74.70%,77.10%,1083,31,110,20,0,161,101,323,205,0,629,1083,30,108,21,0,159,101,319,200,0,620
Liberty,10,83.30%,72.40%,67.50%,83.00%,72.70%,67.80%,4542,135,355,121,1,612,283,933,604,0,1820,4542,126,343,115,1,585,268,915,561,0,1744
Liberty,11,74.70%,59.90%,56.90%,74.70%,60.50%,57.60%,4317,152,676,206,0,1034,201,1009,608,0,1818,4317,150,658,197,0,1005,204,1007,581,0,1792
Liberty,12,87.80%,77.20%,67.30%,84.50%,76.50%,70.50%,1976,51,126,41,1,219,105,427,296,2,830,1976,45,128,50,1,224,108,416,273,2,799
Liberty,13,70.60%,59.40%,46.80%,70.90%,59.80%,48.60%,2304,83,93,45,0,221,73,136,108,0,317,2304,76,90,39,0,205,72,134,95,0,301
Liberty,14,81.80%,76.00%,62.60%,81.20%,75.70%,64.90%,2398,92,225,78,0,395,154,714,350,0,1218,2398,85,225,78,0,388,157,701,337,0,1195
Liberty,2,68.30%,50.40%,52.10%,65.90%,49.20%,52.80%,1984,81,337,103,0,521,88,343,222,0,653,1984,77,339,99,0,515,86,328,191,0,605
Liberty,3,75.70%,48.70%,36.00%,76.80%,48.30%,38.20%,4379,219,994,175,0,1388,123,944,545,0,1612,4379,214,990,161,0,1365,132,926,534,0,1592
Liberty,4,82.00%,75.60%,61.40%,82.70%,74.90%,62.80%,3016,96,261,79,0,436,153,807,360,0,1320,3016,89,265,72,0,426,150,790,345,0,1285
Liberty,5,83.80%,72.80%,55.40%,84.90%,70.50%,59.10%,505,29,47,18,0,94,36,126,93,0,255,505,27,51,16,0,94,39,122,90,0,251
Liberty,6,52.80%,24.90%,19.30%,52.20%,25.40%,20.20%,3239,359,976,200,1,1536,86,323,224,0,633,3239,347,954,193,1,1495,88,324,211,0,623
Liberty,7,72.00%,47.70%,27.50%,72.10%,48.60%,28.30%,3193,272,506,124,0,902,102,462,319,1,884,3193,261,486,115,0,862,102,459,297,1,859
Liberty,9,78.40%,71.20%,60.80%,78.70%,71.10%,62.40%,2646,104,235,101,0,440,161,582,367,0,1110,2646,97,229,94,0,420,161,564,347,0,1072
Lincoln,1-A,60.00%,16.60%,24.60%,58.90%,16.20%,22.50%,587,98,161,44,0,303,32,32,66,0,130,587,100,160,44,0,304,29,31,63,0,123
Lincoln,1-B,84.70%,47.10%,50.40%,85.10%,47.40%,46.60%,799,66,135,29,0,230,65,120,161,2,348,799,70,132,26,0,228,59,119,148,2,328
Lincoln,2,44.10%,16.70%,22.40%,42.40%,16.30%,20.90%,1489,173,559,127,0,859,50,112,100,0,262,1489,174,555,125,0,854,46,108,92,0,246
Lincoln,3-A,61.90%,31.10%,21.20%,64.60%,31.20%,21.20%,489,78,122,32,0,232,21,55,52,0,128,489,78,119,28,0,225,21,54,51,0,126
Lincoln,3-B,71.60%,30.90%,31.40%,71.80%,30.10%,32.40%,1003,133,241,56,0,430,61,108,141,0,310,1003,127,239,53,0,419,61,103,135,0,299
Lincoln,4-A,31.30%,18.00%,7.90%,35.10%,16.20%,10.30%,575,116,169,55,0,340,10,37,25,0,72,575,113,171,48,0,332,13,33,26,0,72
Lincoln,4-B,45.60%,14.60%,9.70%,45.20%,14.20%,9.10%,1234,240,445,99,1,785,26,76,83,0,185,1234,239,440,97,1,777,24,73,80,0,177
Long,1,66.70%,36.50%,30.50%,65.70%,37.10%,32.40%,1539,213,254,48,1,516,93,146,96,1,336,1539,201,248,46,1,496,96,146,88,1,331
Long,2,63.90%,37.20%,18.60%,67.00%,37.10%,20.00%,3131,341,630,84,5,1060,79,373,149,0,601,3131,327,622,73,4,1026,82,367,148,1,598
Long,3,76.90%,45.60%,42.90%,75.50%,46.40%,48.10%,1392,93,210,25,0,328,67,176,83,3,329,1392,83,203,25,0,311,74,176,77,3,330
Long,4,62.90%,43.90%,38.50%,67.50%,44.60%,38.30%,2281,158,400,66,3,627,101,313,112,0,526,2281,150,390,54,3,597,95,314,112,0,521
Long,5,34.00%,15.90%,12.70%,39.50%,17.60%,12.50%,920,151,269,31,0,451,22,51,16,0,89,920,147,262,26,0,435,21,56,17,0,94
Long,6,68.20%,10.30%,9.00%,66.70%,12.10%,13.20%,298,70,96,7,1,174,6,11,15,1,33,298,65,94,7,1,167,9,13,14,1,37
Long,7,50.00%,24.30%,10.70%,50.90%,24.20%,13.60%,909,100,243,29,0,372,11,78,29,1,119,909,95,235,27,0,357,15,75,28,0,118
Lowndes,1,42.30%,19.80%,15.70%,40.70%,19.70%,16.10%,5526,878,1882,307,6,3073,158,464,225,7,854,5526,860,1863,303,4,3030,162,456,208,4,830
Lowndes,2,66.30%,44.80%,39.70%,64.80%,43.90%,38.70%,10900,639,2304,489,21,3453,416,1872,963,19,3270,10900,633,2305,476,21,3435,395,1807,876,18,3096
Lowndes,3,62.30%,36.70%,45.40%,59.60%,35.60%,43.00%,17467,719,4416,929,32,6096,551,2556,1537,73,4717,17467,734,4447,948,31,6160,508,2454,1398,68,4428
Lowndes,4,60.90%,35.50%,21.90%,58.90%,34.40%,20.30%,1291,228,334,52,0,614,61,184,81,3,329,1291,227,333,53,1,614,58,175,76,0,309
Lowndes,5,54.90%,31.90%,34.70%,52.90%,31.00%,34.20%,9877,599,2891,579,27,4096,306,1357,706,26,2395,9877,596,2897,584,26,4103,299,1301,656,24,2280
Lowndes,6,92.30%,81.20%,88.40%,91.50%,79.10%,86.60%,4283,46,206,48,3,303,354,887,575,19,1835,4283,49,222,50,6,327,339,839,536,16,1730
Lowndes,7,50.70%,23.70%,19.00%,51.40%,22.90%,19.30%,4755,639,1230,263,14,2146,146,382,271,7,806,4755,629,1226,247,11,2113,146,364,261,7,778
Lowndes,8,37.20%,15.10%,10.10%,35.40%,15.30%,10.70%,4255,634,1504,258,19,2415,70,267,153,3,493,4255,618,1478,250,19,2365,74,267,137,2,480
Lowndes,9,47.20%,18.50%,16.30%,45.90%,19.20%,17.40%,3967,722,1178,239,15,2154,138,267,214,5,624,3967,702,1156,235,14,2107,147,275,199,4,625
Lowndes,10,100.00%,81.70%,93.90%,100.00%,85.00%,87.80%,318,3,11,0,0,14,44,49,10,2,105,318,6,9,0,0,15,41,51,10,2,104
Lowndes,11,85.50%,79.30%,78.60%,85.50%,78.20%,77.80%,6273,107,413,126,7,653,381,1580,743,37,2741,6273,108,428,119,7,662,367,1535,700,37,2639
Lowndes,12,60.70%,39.40%,32.70%,60.30%,38.90%,33.50%,1997,99,354,59,14,526,45,230,91,10,376,1997,93,352,58,12,515,45,224,88,8,365
Lowndes,13,92.30%,92.80%,86.30%,90.80%,90.90%,82.90%,4447,38,72,30,8,148,222,922,360,68,1572,4447,44,87,34,9,174,205,869,334,52,1460
Lumpkin,DA,38.10%,16.00%,14.20%,36.40%,15.70%,13.30%,22407,2002,8138,2022,1,12163,332,1549,1245,0,3126,22407,1973,7993,1974,1,11941,303,1492,1131,0,2926
Macon,1,71.40%,38.30%,42.00%,69.60%,38.40%,41.90%,1399,130,371,34,0,535,94,230,85,0,409,1399,126,360,34,0,520,91,224,78,0,393
Macon,2,85.20%,53.40%,59.90%,85.70%,52.70%,61.00%,1294,55,279,19,0,353,82,320,109,0,511,1294,53,277,17,0,347,83,309,102,0,494
Macon,3,79.10%,46.60%,69.30%,78.40%,44.50%,69.40%,1344,99,229,32,0,360,223,200,121,0,544,1344,96,234,33,0,363,218,188,120,0,526
Macon,4,86.20%,58.60%,74.00%,85.40%,56.60%,69.30%,1597,47,264,33,0,344,134,373,206,0,713,1597,55,270,33,0,358,124,352,193,0,669
Macon,5,89.80%,68.70%,90.30%,89.00%,66.80%,89.50%,1357,17,153,21,0,191,159,336,185,0,680,1357,18,160,21,0,199,153,322,170,0,645
Madison,COB,49.60%,24.70%,25.90%,49.10%,24.60%,24.20%,3342,454,984,225,1,1664,159,322,221,0,702,3342,452,982,223,0,1657,144,321,215,0,680
Madison,COL,31.80%,12.60%,5.90%,30.20%,12.50%,6.40%,647,191,167,45,0,403,12,24,21,0,57,647,191,161,44,0,396,13,23,19,0,55
Madison,COM,58.60%,26.50%,26.30%,61.40%,25.50%,27.90%,1441,246,369,101,0,716,88,133,143,0,364,1441,235,372,88,0,695,91,127,140,0,358
Madison,DAN,32.10%,12.30%,14.70%,32.90%,12.60%,14.80%,3003,291,1208,285,0,1784,50,169,135,0,354,3003,281,1189,269,0,1739,49,171,132,0,352
Madison,FOR,61.80%,42.60%,14.40%,67.20%,42.60%,16.30%,566,166,81,26,0,273,28,60,42,0,130,566,159,78,21,0,258,31,58,43,0,132
Madison,HAR,9.20%,11.50%,3.60%,9.50%,11.50%,3.30%,610,240,146,59,0,445,9,19,6,0,34,610,236,146,57,0,439,8,19,6,0,33
Madison,HUL,47.80%,30.00%,28.80%,44.90%,29.60%,28.30%,4376,540,1066,343,1,1950,218,457,314,1,990,4376,531,1062,351,1,1945,209,446,286,1,942
Madison,ILA,31.60%,9.90%,10.80%,30.50%,9.30%,12.00%,1746,307,538,156,0,1001,37,59,72,0,168,1746,293,529,146,0,968,40,54,64,0,158
Madison,MIL,34.00%,11.10%,9.30%,32.70%,10.40%,10.10%,1646,322,601,136,1,1060,33,75,70,0,178,1646,320,596,132,1,1049,36,69,64,0,169
Madison,PAO,30.30%,11.00%,8.00%,31.30%,11.00%,8.00%,267,103,65,23,0,191,9,8,10,0,27,267,104,65,22,0,191,9,8,10,0,27
Madison,PIT,34.50%,15.80%,17.10%,33.10%,17.20%,15.50%,1949,358,564,213,0,1135,74,106,112,0,292,1949,359,555,208,0,1122,66,115,103,0,284
Madison,POC,30.30%,12.80%,7.50%,31.00%,12.60%,8.30%,1127,284,314,106,0,704,23,46,46,0,115,1127,275,304,98,0,677,25,44,44,0,113
Marion,339,31.10%,11.40%,2.90%,31.80%,12.00%,4.50%,971,304,234,62,0,600,9,30,28,0,67,971,295,228,60,0,583,14,31,28,0,73
Marion,807,74.70%,50.10%,63.70%,72.80%,48.50%,64.70%,2343,95,512,123,0,730,167,515,364,0,1046,2343,91,524,127,0,742,167,494,340,0,1001
Marion,808,67.70%,11.40%,11.10%,54.80%,8.70%,11.50%,320,104,93,10,0,207,13,12,21,0,46,320,100,94,14,0,208,13,9,17,0,39
Marion,948,41.80%,9.20%,10.00%,37.70%,8.80%,15.40%,396,72,158,32,0,262,8,16,23,0,47,396,66,156,33,0,255,12,15,20,0,47
Marion,955,34.00%,17.30%,11.10%,34.00%,17.30%,13.10%,883,184,224,68,0,476,23,47,35,0,105,883,172,220,68,0,460,26,46,35,0,107
Mcduffie,131,82.70%,74.70%,84.80%,84.80%,73.80%,84.80%,1172,15,99,43,0,157,84,293,206,0,583,1172,15,102,37,0,154,84,287,207,0,578
Mcduffie,132,32.10%,6.60%,12.70%,27.20%,6.20%,9.80%,1507,110,773,142,0,1025,16,55,67,0,138,1507,110,770,150,0,1030,12,51,56,0,119
Mcduffie,133A,54.10%,23.40%,27.80%,54.50%,22.80%,25.40%,1278,104,407,79,0,590,40,124,93,0,257,1278,106,402,75,0,583,36,119,90,0,245
Mcduffie,133B,47.10%,18.90%,17.60%,45.40%,17.60%,19.60%,1959,196,734,128,0,1058,42,171,114,0,327,1959,193,728,125,0,1046,47,156,104,0,307
Mcduffie,134,80.90%,49.50%,66.10%,79.70%,48.00%,63.70%,1908,57,375,79,0,511,111,367,335,0,813,1908,62,385,82,0,529,109,356,321,0,786
Mcduffie,135,49.40%,28.10%,34.60%,46.00%,27.00%,33.60%,3089,170,1048,224,0,1442,90,409,219,0,718,3089,174,1048,232,0,1454,88,388,198,0,674
Mcduffie,136,90.80%,78.90%,84.50%,90.30%,76.10%,79.60%,1940,30,108,33,0,171,164,404,327,0,895,1940,39,119,33,0,191,152,379,308,0,839
Mcduffie,137,38.30%,12.90%,23.40%,36.00%,13.00%,21.10%,1202,72,586,108,0,766,22,87,67,0,176,1202,71,578,112,0,761,19,86,63,0,168
Mcduffie,139,60.30%,30.20%,30.10%,59.00%,29.70%,27.60%,978,72,315,62,0,449,31,136,94,0,261,978,71,315,64,0,450,27,133,92,0,252
Mcintosh,1312,83.30%,50.00%,88.90%,91.70%,50.00%,86.70%,53,2,6,2,0,10,16,6,10,0,32,53,2,6,1,0,9,13,6,11,0,30
Mcintosh,1480,29.90%,30.70%,18.00%,33.00%,30.20%,19.40%,564,82,97,129,0,308,18,43,55,0,116,564,75,97,118,0,290,18,42,58,0,118
Mcintosh,1515,76.30%,58.30%,61.30%,75.50%,57.90%,60.00%,1982,118,303,80,0,501,187,424,257,0,868,1982,120,302,77,0,499,180,415,237,0,832
Mcintosh,1771,45.60%,35.70%,39.30%,45.80%,34.00%,36.30%,2441,119,691,231,0,1041,77,383,194,0,654,2441,121,693,220,0,1034,69,357,186,0,612
Mcintosh,22,40.50%,22.80%,13.40%,39.00%,22.10%,14.20%,2095,302,654,256,1,1213,47,193,174,0,414,2095,295,652,253,1,1201,49,185,162,0,396
Mcintosh,271,54.50%,30.20%,34.20%,53.70%,29.80%,33.70%,2157,187,620,136,0,943,97,268,163,0,528,2157,187,614,133,0,934,95,261,154,0,510
Meriwether,1,47.10%,7.00%,8.50%,41.20%,6.10%,9.00%,451,173,107,27,0,307,16,8,24,0,48,451,171,108,30,0,309,17,7,21,0,45
Meriwether,2,50.40%,27.90%,34.60%,47.20%,26.60%,35.70%,1662,284,338,139,0,761,149,131,141,1,422,1662,268,340,142,0,750,148,123,127,1,399
Meriwether,3,87.30%,67.20%,80.00%,87.10%,67.40%,80.30%,1000,38,78,30,0,146,152,160,207,0,519,1000,37,76,29,0,142,151,157,196,0,504
Meriwether,4,65.10%,19.00%,48.50%,58.10%,16.30%,51.50%,296,35,81,22,0,138,32,19,41,1,93,296,33,82,26,0,141,34,16,36,1,87
Meriwether,5,64.60%,44.10%,49.30%,62.20%,42.90%,48.10%,2009,109,457,110,0,676,105,360,201,1,667,2009,108,463,113,0,684,99,348,186,1,634
Meriwether,6,74.30%,35.30%,35.70%,72.30%,36.10%,36.90%,1263,160,273,59,0,492,89,149,171,0,409,1263,157,269,62,0,488,92,152,162,0,406
Meriwether,7,59.40%,30.80%,29.90%,58.00%,31.20%,30.50%,2760,396,626,164,0,1186,169,278,240,0,687,2760,380,612,161,0,1153,167,278,222,0,667
Meriwether,8,54.50%,25.50%,32.30%,54.30%,25.60%,32.90%,1528,251,359,112,1,723,118,123,134,2,377,1528,242,354,107,1,704,117,122,127,2,368
Meriwether,9,57.60%,13.70%,19.60%,54.00%,13.80%,18.60%,411,82,107,28,0,217,20,17,38,0,75,411,83,106,29,0,218,19,17,34,0,70
Meriwether,10,60.40%,35.80%,52.60%,60.20%,36.00%,52.10%,1363,157,267,89,0,513,174,149,136,0,459,1363,152,263,84,0,499,165,148,127,0,440
Meriwether,11,43.30%,28.40%,36.30%,40.40%,27.90%,35.90%,1161,178,282,85,1,546,102,112,65,0,279,1161,176,279,87,1,543,99,108,59,0,266
Meriwether,12,55.00%,32.90%,20.50%,52.40%,33.60%,22.70%,730,163,145,49,0,357,42,71,60,0,173,730,157,142,49,0,348,46,72,54,0,172
Meriwether,13,41.00%,14.30%,12.40%,37.30%,13.60%,13.40%,501,113,162,36,0,311,16,27,25,0,68,501,110,159,37,0,306,17,25,22,0,64
Meriwether,14,16.70%,0.00%,5.20%,14.70%,6.70%,6.30%,202,91,30,30,0,151,5,0,6,0,11,202,90,28,29,0,147,6,2,5,0,13
Miller,1,45.60%,21.80%,24.60%,43.30%,20.30%,24.00%,3912,530,1269,264,3,2066,174,354,221,0,749,3912,525,1258,262,2,2047,166,321,200,0,687
Mitchell,BA,73.60%,37.70%,38.60%,72.50%,37.40%,39.10%,1129,156,205,39,0,400,98,124,109,0,331,1129,151,206,39,0,396,97,123,103,0,323
Mitchell,BV,51.80%,18.40%,6.00%,53.70%,17.40%,6.60%,599,172,186,27,0,385,11,42,29,0,82,599,169,185,25,0,379,12,39,29,0,80
Mitchell,CN,93.20%,70.20%,82.20%,91.20%,68.10%,80.50%,1996,42,178,28,0,248,194,420,386,0,1000,1996,46,187,35,0,268,190,399,364,0,953
Mitchell,CS,66.50%,39.70%,60.80%,64.50%,39.00%,58.20%,3475,114,871,212,0,1197,174,573,421,3,1171,3475,119,868,218,0,1205,163,555,396,3,1117
Mitchell,CT,20.50%,7.70%,6.70%,22.50%,7.70%,6.70%,399,181,72,35,0,288,13,6,9,0,28,399,180,72,31,0,283,13,6,9,0,28
Mitchell,HF,38.50%,10.80%,12.50%,36.10%,11.70%,10.80%,350,96,91,24,2,213,14,11,15,0,40,350,97,91,23,2,213,12,12,13,0,37
Mitchell,HI,72.70%,19.00%,1.30%,66.70%,23.80%,2.50%,134,79,17,3,0,99,1,4,8,0,13,134,78,16,3,0,97,2,5,6,0,13
Mitchell,LS,46.40%,13.20%,10.60%,47.40%,13.90%,12.10%,1357,278,330,96,0,704,32,50,83,1,166,1357,269,321,91,0,681,36,52,82,1,171
Mitchell,PC,15.00%,29.40%,10.80%,5.30%,21.20%,9.60%,162,66,24,17,0,107,8,10,3,0,21,162,66,26,18,0,110,7,7,1,0,15
Mitchell,PE,70.20%,37.60%,53.00%,67.90%,37.50%,51.90%,3489,224,679,177,0,1080,252,410,417,1,1080,3489,224,671,184,0,1079,241,402,390,1,1034
Mitchell,SC,45.20%,32.40%,12.80%,43.90%,31.90%,13.00%,384,143,48,23,0,214,21,23,19,0,63,384,140,47,23,0,210,21,22,18,0,61
Monroe,1,44.40%,18.60%,12.10%,41.70%,17.60%,12.10%,2297,342,940,175,1,1458,47,215,140,0,402,2297,332,943,175,1,1451,46,201,125,0,372
Monroe,2,41.10%,13.40%,7.10%,33.30%,13.10%,7.30%,1123,221,519,56,0,796,17,80,39,0,136,1123,216,516,58,0,790,17,78,29,0,124
Monroe,3,40.00%,18.10%,9.80%,35.50%,17.30%,9.30%,2268,422,924,174,3,1523,45,204,116,1,366,2268,425,931,176,3,1535,43,195,97,1,336
Monroe,4,56.90%,28.50%,16.70%,54.20%,29.00%,19.00%,800,198,188,28,1,415,40,75,37,0,152,800,187,184,27,1,399,44,75,32,0,151
Monroe,5,70.50%,16.60%,19.30%,68.90%,16.80%,19.20%,718,138,272,18,0,428,33,54,43,0,130,718,135,267,19,0,421,32,54,42,0,128
Monroe,6,51.70%,30.60%,31.10%,50.00%,31.80%,30.10%,454,111,75,28,0,214,49,33,30,1,113,454,109,73,29,0,211,46,34,29,1,110
Monroe,7,48.60%,16.60%,14.90%,51.40%,16.00%,14.80%,996,149,372,37,0,558,26,74,35,0,135,996,144,372,35,0,551,25,71,37,0,133
Monroe,8,42.20%,18.00%,15.80%,38.10%,17.50%,18.00%,2127,282,873,119,0,1274,53,192,87,0,332,2127,259,867,122,0,1248,57,184,75,0,316
Monroe,9,79.60%,49.30%,48.60%,78.80%,48.10%,48.10%,4640,208,976,150,0,1334,197,948,587,0,1732,4640,206,985,150,0,1341,191,913,557,0,1661
Monroe,10,38.30%,14.60%,9.90%,39.40%,14.10%,13.50%,1994,345,610,113,1,1069,38,104,70,0,212,1994,327,597,103,1,1028,51,98,67,0,216
Monroe,11,73.90%,45.00%,23.30%,69.50%,46.90%,24.70%,722,122,154,29,0,305,37,126,82,0,245,722,113,147,32,0,292,37,130,73,0,240
Monroe,12,42.10%,14.90%,11.90%,39.20%,15.60%,13.20%,1319,207,541,62,0,810,28,95,45,0,168,1319,203,534,62,0,799,31,99,40,0,170
Monroe,13,44.20%,23.50%,20.10%,43.30%,23.20%,21.50%,1214,223,319,58,0,600,56,98,46,0,200,1214,216,315,55,0,586,59,95,42,0,196
Monroe,14,50.00%,14.80%,15.20%,43.30%,11.80%,14.20%,466,134,127,15,0,276,24,22,15,0,61,466,133,127,17,0,277,22,17,13,0,52
Montgomery,1,59.30%,19.70%,27.20%,59.30%,19.50%,25.30%,431,67,155,22,0,244,25,38,32,0,95,431,68,153,22,0,243,23,37,32,0,92
Montgomery,2,27.10%,15.30%,5.40%,26.10%,16.00%,6.20%,472,140,150,35,0,325,8,27,13,0,48,472,136,147,34,0,317,9,28,12,0,49
Montgomery,3,50.30%,18.60%,13.90%,45.30%,18.20%,13.90%,1340,273,420,76,0,769,44,96,77,0,217,1340,267,417,82,0,766,43,93,68,0,204
Montgomery,4,22.40%,6.90%,4.10%,21.10%,7.00%,7.10%,532,162,148,59,0,369,7,11,17,0,35,532,157,147,56,0,360,12,11,15,0,38
Montgomery,5,60.80%,35.80%,43.60%,56.60%,32.70%,40.30%,1444,146,326,73,0,545,113,182,113,0,408,1444,151,335,76,0,562,102,163,99,0,364
Montgomery,6,12.80%,2.00%,7.20%,8.30%,3.00%,7.30%,333,116,97,34,0,247,9,2,5,0,16,333,115,96,33,0,244,9,3,3,0,15
Montgomery,7,48.20%,24.00%,17.70%,51.00%,24.60%,21.70%,911,205,199,57,0,461,44,63,53,0,160,911,191,193,51,0,435,53,63,53,0,169
Morgan,1,76.80%,48.10%,60.90%,74.60%,46.70%,59.70%,2919,100,721,115,0,936,155,668,381,1,1205,2919,104,735,119,0,958,153,643,350,1,1147
Morgan,2,45.10%,20.60%,12.30%,44.30%,20.10%,11.60%,2228,413,858,139,2,1412,58,223,114,0,395,2228,426,851,131,2,1410,56,214,104,0,374
Morgan,3,45.90%,12.10%,16.70%,46.60%,11.50%,16.30%,862,140,340,73,0,553,28,47,62,0,137,862,139,338,70,0,547,27,44,61,0,132
Morgan,4,48.30%,23.50%,29.20%,45.50%,21.80%,27.20%,2761,209,1123,211,0,1543,86,345,197,0,628,2761,211,1136,211,0,1558,79,316,176,0,571
Morgan,5,47.30%,12.30%,8.80%,44.00%,12.00%,6.80%,709,135,328,39,0,502,13,46,35,0,94,709,136,330,42,0,508,10,45,33,0,88
Morgan,6,40.60%,16.90%,17.30%,40.30%,15.30%,16.20%,2655,405,1119,158,0,1682,85,228,108,0,421,2655,403,1130,154,0,1687,78,204,104,0,386
Morgan,7,41.70%,21.60%,13.40%,39.80%,21.50%,12.30%,2690,463,935,203,1,1602,71,258,145,1,475,2690,457,930,203,1,1591,64,255,134,0,453
Murray,1013,33.30%,10.50%,13.90%,30.40%,11.00%,14.40%,2524,335,980,138,0,1453,54,115,69,0,238,2524,326,949,135,0,1410,55,117,59,0,231
Murray,1039,32.20%,14.90%,15.30%,32.10%,14.70%,16.20%,2940,618,914,145,0,1677,112,160,69,0,341,2940,597,890,129,0,1616,115,153,61,0,329
Murray,1291,23.00%,10.00%,9.40%,24.80%,10.80%,10.50%,3215,697,859,201,0,1757,72,95,60,0,227,3215,668,815,188,0,1671,78,99,62,0,239
Murray,1895,43.10%,13.80%,17.10%,43.30%,13.90%,18.70%,3671,528,1343,197,0,2068,109,215,149,0,473,3671,504,1318,186,0,2008,116,212,142,0,470
Murray,824,34.80%,14.10%,13.00%,33.70%,14.30%,14.20%,5766,671,2316,416,0,3403,100,380,222,0,702,5766,649,2255,395,0,3299,107,375,201,0,683
Murray,872,26.70%,9.80%,7.80%,28.20%,11.20%,9.20%,2045,482,608,137,0,1227,41,66,50,0,157,2045,466,581,127,0,1174,47,73,50,0,170
Murray,874,32.10%,8.50%,7.00%,35.00%,8.50%,8.50%,2123,562,669,127,0,1358,42,62,60,0,164,2123,546,654,115,0,1315,51,61,62,0,174
Muscogee,101,83.40%,71.50%,73.20%,80.10%,70.20%,72.60%,5289,124,433,159,0,716,339,1088,801,0,2228,5289,124,445,182,0,751,329,1049,734,0,2112
Muscogee,102,95.70%,95.10%,90.70%,94.40%,95.00%,91.40%,4374,25,59,38,0,122,243,1139,845,0,2227,4374,23,59,47,0,129,243,1118,798,0,2159
Muscogee,103,94.30%,93.50%,86.30%,92.50%,93.10%,88.90%,5341,42,117,71,0,230,261,1694,1166,3,3124,5341,34,123,89,0,246,269,1662,1102,3,3036
Muscogee,104,57.60%,39.30%,29.50%,55.10%,39.80%,29.20%,2747,304,550,177,0,1031,127,356,240,0,723,2747,300,530,183,0,1013,124,351,225,0,700
Muscogee,105,57.70%,36.10%,28.30%,54.20%,36.70%,29.00%,3265,353,730,259,4,1346,141,413,354,0,908,3265,349,715,266,4,1334,144,414,315,0,873
Muscogee,106,57.00%,38.60%,27.60%,54.10%,38.30%,26.80%,6684,649,1500,491,0,2640,247,943,650,1,1841,6684,653,1488,498,0,2639,238,924,588,1,1751
Muscogee,107,64.70%,40.10%,43.60%,63.60%,39.30%,43.00%,4464,285,643,190,0,1118,220,431,349,0,1000,4464,282,643,187,0,1112,213,416,327,0,956
Muscogee,108,54.50%,27.90%,22.00%,51.20%,26.90%,22.20%,6492,567,2078,593,5,3243,155,805,710,6,1676,6492,570,2095,616,5,3286,158,770,647,6,1581
Muscogee,109,48.40%,27.00%,18.30%,40.80%,23.60%,15.40%,2692,245,820,388,0,1453,55,303,364,0,722,2692,251,851,432,1,1535,46,263,298,0,607
Muscogee,110,93.00%,94.50%,90.90%,93.30%,93.70%,89.20%,6169,53,70,65,0,188,526,1203,857,3,2589,6169,62,78,58,0,198,507,1164,802,3,2476
Muscogee,112,85.50%,80.50%,70.50%,84.10%,80.10%,71.70%,10204,245,393,224,2,864,585,1625,1323,4,3537,10204,231,392,232,1,856,584,1576,1224,4,3388
Muscogee,113,96.90%,94.30%,87.40%,95.90%,94.10%,88.90%,6022,61,113,38,0,212,422,1856,1186,1,3465,6022,52,114,48,0,214,415,1825,1134,1,3375
Muscogee,114,92.60%,93.00%,86.00%,92.00%,92.80%,84.70%,4461,54,104,69,0,227,333,1376,858,0,2567,4461,58,106,72,0,236,321,1364,823,0,2508
Muscogee,115,84.70%,84.00%,76.00%,83.40%,83.00%,74.50%,7078,124,336,204,0,664,392,1766,1128,0,3286,7078,132,352,210,0,694,385,1724,1058,0,3167
Muscogee,116,88.40%,87.80%,84.00%,87.30%,87.60%,83.10%,7613,85,303,165,0,553,445,2189,1262,0,3896,7613,89,305,171,0,565,437,2149,1171,0,3757
Muscogee,117,62.20%,52.50%,39.40%,60.50%,51.70%,41.60%,5612,408,886,376,0,1670,265,980,620,0,1865,5612,386,889,385,0,1660,275,950,589,0,1814
Muscogee,118,59.10%,39.20%,40.70%,55.50%,38.40%,39.10%,5677,360,1380,450,0,2190,247,888,650,0,1785,5677,368,1390,477,0,2235,236,866,595,0,1697
Muscogee,119,53.60%,36.40%,31.00%,51.70%,36.60%,32.70%,5415,485,1205,456,0,2146,217,689,527,1,1434,5415,463,1185,461,0,2109,225,684,494,0,1403
Muscogee,120,61.20%,42.90%,32.30%,58.00%,42.30%,32.10%,7959,672,1725,627,0,3024,321,1295,989,0,2605,7959,657,1733,650,0,3040,311,1268,898,0,2477
Muscogee,121,65.10%,52.50%,39.70%,61.50%,51.80%,40.10%,3192,260,539,195,0,994,170,595,363,1,1129,3192,251,540,205,0,996,168,580,327,0,1075
Muscogee,122,81.40%,70.90%,65.80%,79.20%,68.10%,64.50%,1955,54,123,60,1,238,102,299,263,4,668,1955,53,133,65,2,253,97,284,248,3,632
Muscogee,124,59.40%,44.50%,38.10%,56.90%,44.70%,38.30%,4512,344,690,285,1,1320,212,554,417,0,1183,4512,339,676,286,1,1302,211,547,378,0,1136
Muscogee,125,81.80%,71.70%,62.40%,81.00%,70.60%,65.10%,3095,113,192,75,2,382,186,486,337,5,1014,3095,102,191,74,1,368,188,459,315,4,966
Muscogee,126,75.10%,70.80%,48.00%,76.60%,70.30%,47.70%,3235,179,317,143,2,641,164,767,431,3,1365,3235,176,312,127,3,618,161,740,416,2,1319
Muscogee,127,62.50%,45.20%,32.00%,60.70%,44.10%,34.20%,7331,436,1800,601,0,2837,204,1487,1000,1,2692,7331,412,1815,610,0,2837,213,1430,943,1,2587
Newton,1,75.20%,57.30%,52.90%,73.80%,57.20%,52.90%,1833,172,140,86,0,398,193,188,261,0,642,1833,172,140,86,0,398,193,187,242,0,622
Newton,2,81.70%,73.60%,72.60%,81.00%,72.90%,72.40%,4378,203,228,174,0,605,538,636,776,1,1951,4378,200,230,174,0,604,524,620,741,1,1886
Newton,3,83.00%,81.40%,64.30%,83.20%,81.70%,66.40%,5009,284,288,191,0,763,507,1260,934,4,2705,5009,263,279,183,0,725,517,1246,906,2,2671
Newton,4,58.20%,52.00%,35.60%,57.00%,51.70%,34.80%,4620,568,702,416,1,1687,313,760,580,2,1655,4620,573,700,415,1,1689,304,748,550,2,1604
Newton,5,59.90%,56.30%,43.50%,58.90%,56.00%,43.90%,3111,356,341,248,1,946,275,440,370,0,1085,3111,353,343,240,1,937,277,437,344,0,1058
Newton,6,48.50%,31.60%,15.80%,48.10%,31.80%,16.20%,3538,1103,475,265,2,1845,205,219,250,2,676,3538,1086,467,256,2,1811,210,218,237,1,666
Newton,7,44.60%,32.10%,16.50%,45.30%,32.00%,17.30%,2623,748,426,267,0,1441,148,201,215,0,564,2623,740,422,255,0,1417,155,199,211,0,565
Newton,8,68.10%,60.80%,43.10%,68.50%,62.20%,43.70%,2838,366,233,160,0,759,276,361,342,1,980,2838,355,219,151,0,725,275,361,329,1,966
Newton,9,81.20%,74.00%,55.70%,80.40%,74.40%,57.10%,4593,338,325,171,3,837,424,927,739,4,2094,4593,320,318,170,3,811,428,922,699,2,2051
Newton,10,72.00%,54.70%,39.00%,72.00%,54.90%,39.60%,6215,758,868,327,1,1954,485,1049,840,0,2374,6215,741,856,311,1,1909,486,1040,799,0,2325
Newton,12,41.30%,34.10%,15.20%,40.30%,32.80%,15.40%,4135,930,794,519,1,2244,167,411,365,0,943,4135,921,802,514,1,2238,168,391,347,0,906
Newton,13,84.00%,81.60%,72.40%,84.60%,81.90%,74.10%,5428,228,309,173,0,710,596,1366,907,3,2872,5428,210,299,161,0,670,598,1357,885,3,2843
Newton,14,44.00%,29.00%,13.80%,43.50%,27.50%,14.60%,2177,720,294,210,3,1227,116,120,165,0,401,2177,701,296,203,2,1202,120,112,156,0,388
Newton,15,35.40%,11.60%,6.60%,31.90%,12.10%,6.90%,1524,774,168,124,0,1066,55,22,68,0,145,1524,773,167,128,0,1068,57,23,60,0,140
Newton,16,47.30%,19.20%,11.70%,43.50%,19.20%,13.20%,784,386,59,49,0,494,51,14,44,0,109,784,380,59,52,0,491,58,14,40,0,112
Newton,17,48.50%,31.10%,21.60%,47.80%,29.40%,22.50%,2418,544,376,283,1,1204,150,170,266,0,586,2418,535,377,277,0,1189,154,157,254,1,566
Newton,18,63.10%,47.20%,33.10%,62.30%,48.10%,33.10%,3658,578,502,216,1,1297,286,449,369,1,1105,3658,570,488,214,1,1273,281,452,353,1,1087
Newton,19,70.80%,55.40%,44.10%,71.20%,55.30%,45.40%,4839,529,574,291,1,1395,417,712,705,1,1835,4839,505,568,275,1,1349,419,703,681,1,1804
Newton,20,77.40%,78.10%,66.00%,78.60%,79.00%,67.90%,4969,257,320,228,0,805,498,1138,780,0,2416,4969,240,304,205,0,749,507,1146,751,0,2404
Newton,23,89.00%,87.00%,84.90%,89.10%,87.70%,84.60%,2953,68,100,63,2,233,394,669,509,1,1573,2953,68,94,60,2,224,385,668,490,1,1544
Newton,24,89.00%,88.70%,81.90%,90.10%,89.00%,82.60%,4977,124,168,107,0,399,558,1319,864,2,2743,4977,117,161,92,0,370,554,1300,840,1,2695
Newton,25,29.50%,23.20%,9.80%,27.40%,22.00%,9.50%,2374,854,413,292,1,1560,93,125,122,0,340,2374,849,419,291,0,1559,89,118,110,0,317
Oconee,1,57.60%,37.60%,28.40%,53.00%,35.40%,26.60%,3910,244,1298,312,0,1854,97,783,423,0,1303,3910,246,1343,338,0,1927,89,735,381,0,1205
Oconee,2,51.90%,26.90%,16.80%,48.10%,24.90%,16.00%,1847,182,749,169,1,1101,37,275,182,0,494,1847,178,765,175,0,1118,34,254,162,0,450
Oconee,3,46.70%,19.30%,15.90%,43.80%,18.00%,15.40%,1397,217,528,129,0,874,41,126,113,0,280,1397,214,533,131,0,878,39,117,102,0,258
Oconee,4,57.40%,28.00%,13.30%,57.70%,25.30%,13.50%,737,144,231,46,0,421,22,90,62,0,174,737,141,236,44,0,421,22,80,60,0,162
Oconee,5,56.10%,26.80%,23.00%,50.90%,24.60%,19.50%,1938,193,747,145,1,1086,57,274,185,1,517,1938,201,765,159,1,1126,48,249,165,1,463
Oconee,6,46.20%,26.90%,18.40%,42.50%,23.90%,16.30%,1939,200,816,161,0,1177,45,300,138,0,483,1939,200,845,168,0,1213,39,265,124,0,428
Oconee,7,46.60%,24.50%,13.00%,37.60%,22.00%,9.70%,1244,160,503,109,0,772,24,163,95,0,282,1244,167,520,123,0,810,18,147,74,0,239
Oconee,8,40.90%,19.50%,13.50%,37.60%,18.30%,11.60%,3541,418,1574,317,0,2309,64,382,219,1,666,3541,425,1598,328,0,2351,55,359,198,1,613
Oconee,9,46.10%,26.70%,22.60%,44.70%,25.20%,21.90%,2384,287,800,212,0,1299,84,292,181,0,557,2384,289,812,207,0,1308,81,273,167,0,521
Oconee,10,52.70%,28.20%,26.80%,47.80%,26.20%,23.10%,4091,242,1492,482,1,2217,89,585,537,0,1211,4091,259,1534,524,1,2318,78,544,479,0,1101
Oconee,11,62.90%,32.50%,40.70%,58.70%,30.30%,37.00%,2647,112,900,205,0,1217,77,433,347,0,857,2647,119,937,227,0,1283,70,407,322,0,799
Oconee,12,55.50%,32.00%,23.40%,50.70%,29.40%,23.40%,4396,281,1578,409,0,2268,86,741,511,0,1338,4396,279,1626,450,0,2355,85,678,463,0,1226
Oglethorpe,BV,47.70%,24.40%,21.90%,46.90%,23.60%,22.20%,3509,479,1059,297,0,1835,134,341,271,0,746,3509,467,1051,289,0,1807,133,325,255,0,713
Oglethorpe,CR,49.30%,26.50%,32.30%,46.90%,26.10%,33.10%,3044,267,953,246,1,1467,128,343,239,0,710,3044,258,934,246,1,1439,128,330,217,0,675
Oglethorpe,LX,47.00%,22.90%,33.10%,47.10%,22.40%,31.20%,4291,315,1572,403,1,2291,155,466,358,1,980,4291,321,1549,383,1,2254,144,448,341,2,935
Paulding,0001B,32.60%,14.90%,16.10%,32.00%,14.60%,15.00%,6242,619,2801,611,5,4036,119,489,296,1,905,6242,604,2781,595,4,3984,105,474,280,2,861
Paulding,0002C,47.00%,22.30%,24.50%,44.00%,21.50%,23.60%,3662,319,1478,408,1,2206,103,425,362,1,891,3662,316,1479,409,1,2205,98,405,322,0,825
Paulding,0003C,52.80%,33.00%,27.70%,53.20%,32.60%,27.60%,5095,469,1641,424,3,2537,179,809,474,2,1464,5095,455,1628,405,3,2491,174,789,460,1,1424
Paulding,0004C,49.00%,27.50%,23.80%,47.30%,27.20%,24.90%,8243,706,2767,992,4,4469,220,1052,955,2,2229,8243,686,2743,983,4,4416,226,1023,883,3,2135
Paulding,0005C,58.10%,32.30%,27.80%,56.50%,33.00%,28.80%,5972,511,1838,405,6,2760,196,876,561,3,1636,5972,496,1786,404,6,2692,201,881,524,2,1608
Paulding,0006B,50.20%,36.20%,32.50%,48.50%,35.80%,33.00%,4443,313,1084,454,1,1852,147,615,457,4,1223,4443,305,1074,441,1,1821,147,599,416,4,1166
Paulding,0007B,54.80%,36.80%,37.60%,53.90%,37.40%,38.10%,10774,642,2750,833,8,4233,388,1600,1009,3,3000,10774,617,2675,801,8,4101,381,1597,935,3,2916
Paulding,0008C,46.60%,26.30%,24.50%,46.10%,26.40%,24.40%,11546,1035,3651,1166,4,5856,336,1302,1019,1,2658,11546,1010,3600,1116,4,5730,327,1288,955,1,2571
Paulding,0009B,72.80%,61.10%,52.10%,72.00%,60.50%,53.80%,4923,229,753,296,3,1281,249,1182,792,3,2226,4923,220,751,288,3,1262,257,1151,741,3,2152
Paulding,0010B,66.90%,51.30%,48.10%,66.30%,51.70%,49.10%,4825,270,954,292,0,1516,249,1004,589,1,1843,4825,257,931,284,0,1472,247,998,558,1,1804
Paulding,0011C,62.30%,32.50%,33.30%,62.40%,32.60%,34.50%,7137,503,2230,381,2,3116,251,1076,629,1,1957,7137,488,2202,361,2,3053,257,1067,600,1,1925
Paulding,0012C,48.20%,22.50%,21.20%,47.60%,22.50%,21.00%,10070,1097,3269,763,4,5133,290,950,711,7,1958,10070,1069,3218,738,4,5029,279,932,671,6,1888
Paulding,0013B,53.40%,31.50%,30.70%,53.20%,31.20%,32.00%,5833,500,1649,433,6,2588,221,758,496,3,1478,5833,470,1641,411,6,2528,221,744,468,3,1436
Paulding,0014B,32.70%,14.10%,14.90%,30.50%,14.00%,14.60%,5911,703,2345,574,4,3626,123,384,279,1,787,5911,697,2305,570,3,3575,119,375,250,1,745
Paulding,0015C,43.10%,18.20%,13.60%,43.10%,19.10%,14.20%,2547,364,897,185,3,1449,58,199,140,0,397,2547,359,873,173,3,1408,60,206,131,0,397
Paulding,0016C,43.10%,20.20%,16.40%,42.30%,19.90%,17.60%,4132,543,1339,325,3,2210,105,338,246,2,691,4132,521,1324,310,3,2158,110,329,227,2,668
Paulding,0017C,51.10%,23.50%,20.20%,48.40%,23.00%,21.70%,2748,300,957,269,0,1526,75,294,281,1,651,2748,292,950,268,0,1510,80,284,251,1,616
Paulding,0018C,43.10%,34.60%,39.60%,42.50%,34.40%,41.80%,2761,169,783,290,0,1242,110,414,220,1,745,2761,159,767,276,0,1202,114,403,204,0,721
Paulding,0019C,67.70%,44.70%,45.20%,67.20%,44.60%,46.20%,8081,418,1988,481,2,2889,344,1609,1009,3,2965,8081,397,1981,468,2,2848,341,1593,961,2,2897
Peach,B1,54.40%,24.90%,31.80%,53.30%,24.70%,31.80%,2636,157,1118,131,2,1408,74,370,156,0,600,2636,158,1103,128,1,1390,73,361,146,1,581
Peach,B2,58.10%,32.30%,32.60%,55.60%,31.90%,34.80%,5028,251,1746,299,3,2299,121,832,415,2,1370,5028,241,1736,300,3,2280,128,814,375,2,1319
Peach,C1,39.10%,17.40%,15.90%,38.80%,17.90%,16.30%,908,174,314,53,0,541,32,66,34,1,133,908,175,311,52,0,538,33,68,33,1,135
Peach,F1,72.00%,56.90%,62.70%,71.60%,55.40%,62.90%,2669,100,465,115,1,681,170,613,296,0,1079,2669,100,469,111,1,681,171,582,280,0,1033
Peach,F2,79.30%,60.10%,64.50%,78.80%,58.70%,60.90%,2670,92,395,76,1,564,169,595,291,0,1055,2670,101,401,76,1,579,159,571,282,0,1012
Peach,F3,90.50%,79.00%,89.30%,89.40%,77.80%,85.70%,2720,26,192,48,0,266,215,723,459,2,1399,2720,34,200,52,0,286,203,702,439,1,1345
Peach,P1,50.60%,24.90%,15.60%,48.30%,24.80%,17.90%,1365,154,498,88,3,743,28,165,90,1,284,1365,148,489,89,3,729,32,161,83,1,277
Pickens,1,46.70%,17.80%,12.00%,42.20%,16.10%,10.90%,3571,791,968,302,0,2061,108,210,265,0,583,3571,786,977,317,0,2080,96,188,231,0,515
Pickens,2,44.00%,16.80%,13.60%,41.40%,15.60%,13.10%,2616,585,692,308,1,1586,92,140,242,0,474,2616,584,693,309,1,1587,88,128,218,0,434
Pickens,3,32.50%,15.10%,11.30%,30.90%,15.20%,11.10%,1933,392,584,160,0,1136,50,104,77,0,231,1933,385,580,159,0,1124,48,104,71,0,223
Pickens,4,32.50%,12.30%,7.70%,33.20%,12.80%,8.20%,2490,560,767,172,0,1499,47,108,83,0,238,2490,546,745,167,0,1458,49,109,83,0,241
Pickens,5,34.40%,14.10%,10.60%,32.90%,13.60%,10.50%,2042,519,578,160,2,1259,62,95,84,0,241,2042,519,577,159,2,1257,61,91,78,0,230
Pickens,6,28.00%,11.00%,8.00%,31.10%,9.20%,7.80%,825,310,145,36,0,491,27,18,14,0,59,825,309,148,31,0,488,26,15,14,0,55
Pickens,7,42.70%,10.90%,6.70%,41.80%,10.60%,7.20%,1145,503,197,55,0,755,36,24,41,0,101,1145,488,195,53,0,736,38,23,38,0,99
Pickens,8,27.90%,9.40%,4.80%,32.60%,9.70%,6.20%,721,315,96,31,0,442,16,10,12,0,38,721,301,93,29,0,423,20,10,14,0,44
Pickens,9,37.90%,12.90%,9.60%,36.90%,14.10%,10.40%,1474,415,364,87,0,866,44,54,53,0,151,1474,405,354,89,0,848,47,58,52,0,157
Pickens,10,24.70%,12.20%,4.30%,22.20%,11.30%,4.90%,1781,481,468,134,3,1086,22,65,44,0,131,1781,462,464,130,3,1059,24,59,37,0,120
Pickens,11,43.80%,17.00%,16.20%,43.00%,17.50%,18.40%,2517,453,633,153,1,1240,88,130,119,0,337,2517,435,610,146,1,1192,98,129,110,0,337
Pickens,12,31.10%,9.80%,7.30%,28.40%,10.30%,8.50%,2651,670,795,188,1,1654,53,86,85,0,224,2651,647,773,187,1,1608,60,89,74,0,223
Pierce,1,41.60%,16.50%,12.50%,38.50%,15.50%,13.40%,3524,251,1421,226,0,1898,36,281,161,0,478,3524,246,1416,227,0,1889,38,259,142,0,439
Pierce,2,22.80%,7.60%,11.20%,21.40%,7.60%,11.40%,3207,278,1451,240,0,1969,35,120,71,0,226,3207,271,1417,231,0,1919,35,116,63,0,214
Pierce,3A,21.00%,5.50%,10.10%,13.60%,6.00%,10.90%,1611,134,840,139,0,1113,15,49,37,0,101,1611,131,827,146,0,1104,16,53,23,0,92
Pierce,3B,22.80%,6.10%,3.90%,18.30%,5.60%,3.90%,1397,199,631,105,0,935,8,41,31,0,80,1397,195,624,107,0,926,8,37,24,0,69
Pierce,4A,33.10%,11.70%,9.30%,29.70%,11.10%,8.10%,1311,205,537,79,0,821,21,71,39,0,131,1311,204,535,78,0,817,18,67,33,0,118
Pierce,4B,22.80%,3.80%,4.90%,11.30%,3.40%,10.30%,478,39,254,44,0,337,2,10,13,0,25,478,35,253,47,0,335,4,9,6,0,19
Pierce,4C,21.90%,6.70%,6.30%,16.90%,6.20%,6.30%,918,74,471,57,0,602,5,34,16,0,55,918,74,466,59,0,599,5,31,12,0,48
Pierce,4D,0.00%,2.40%,0.00%,0.00%,1.80%,0.00%,271,28,163,33,0,224,0,4,0,0,4,271,28,162,31,0,221,0,3,0,0,3
Pike,1,53.40%,15.50%,18.30%,52.20%,15.20%,17.50%,0,281,524,76,0,881,62,96,87,1,246,0,283,528,75,0,886,59,95,82,1,237
Pike,2,27.10%,5.70%,4.40%,27.10%,5.80%,3.60%,0,349,796,132,0,1277,16,48,49,0,113,0,345,793,121,0,1259,13,49,45,0,107
Pike,3,21.60%,8.70%,9.40%,22.00%,8.90%,10.80%,0,279,548,80,0,907,29,52,22,0,103,0,272,544,78,0,894,33,53,22,0,108
Pike,4,36.30%,11.90%,13.60%,31.90%,12.10%,13.60%,0,347,538,93,2,980,54,73,53,1,181,0,341,528,94,2,965,53,73,44,1,171
Pike,5,29.10%,8.70%,10.50%,27.20%,8.20%,9.20%,0,367,1231,200,1,1799,43,118,82,0,243,0,366,1226,193,1,1786,37,109,72,0,218
Pike,6,33.30%,7.80%,8.80%,32.00%,7.80%,8.10%,0,207,476,88,0,771,20,40,44,0,104,0,205,471,87,0,763,18,40,41,0,99
Pike,7,30.40%,8.60%,9.30%,31.00%,8.10%,9.70%,0,291,836,117,0,1244,30,79,51,0,160,0,289,834,109,0,1232,31,74,49,0,154
Pike,8,50.40%,17.10%,12.40%,48.20%,16.80%,11.40%,0,220,915,133,0,1268,31,189,135,0,355,0,217,910,133,0,1260,28,184,124,0,336
Polk,1,34.50%,14.70%,11.20%,33.80%,14.50%,13.00%,3224,499,1207,218,2,1926,63,208,115,0,386,3224,480,1197,208,2,1887,72,203,106,0,381
Polk,2,32.30%,14.50%,11.80%,33.50%,14.00%,13.20%,1659,284,572,109,1,966,37,97,52,1,187,1659,275,561,103,2,941,42,91,52,0,185
Polk,3,45.20%,27.90%,30.60%,43.30%,27.30%,31.90%,6205,480,1778,520,5,2783,211,688,429,3,1331,6205,456,1756,506,5,2723,213,661,386,3,1263
Polk,4,34.70%,12.20%,13.20%,32.00%,12.30%,13.20%,2566,380,1027,175,2,1584,58,143,93,0,294,2566,374,1000,174,2,1550,57,140,82,0,279
Polk,5,31.20%,11.80%,10.50%,31.40%,12.30%,11.00%,2828,402,1314,185,0,1901,47,175,84,0,306,2828,390,1288,177,0,1855,48,180,81,0,309
Polk,6,44.20%,19.40%,24.30%,43.10%,19.50%,24.40%,5746,492,2349,336,1,3178,156,565,266,2,989,5746,477,2302,324,1,3104,152,559,245,2,958
Polk,7,23.00%,9.50%,10.10%,25.40%,9.50%,8.80%,1961,312,774,164,1,1251,35,81,49,0,165,1961,310,758,153,1,1222,30,80,52,0,162
Pulaski,ANNEX,51.80%,24.90%,32.90%,49.60%,24.00%,31.50%,5687,336,2155,313,1,2805,165,715,337,0,1217,5687,332,2141,314,0,2787,153,677,309,0,1139
Putnam,101,64.40%,35.20%,48.30%,63.50%,35.30%,48.30%,3264,153,850,213,0,1216,143,462,386,0,991,3264,151,838,211,0,1200,141,458,367,0,966
Putnam,104,66.50%,40.90%,48.00%,64.90%,40.40%,46.60%,3380,159,795,227,0,1181,147,550,451,0,1148,3380,163,797,233,0,1193,142,540,431,0,1113
Putnam,105,32.10%,12.50%,13.70%,28.50%,11.30%,12.50%,3734,409,1459,603,1,2472,65,208,285,0,558,3734,405,1478,619,1,2503,58,188,247,0,493
Putnam,106,31.60%,13.90%,8.80%,31.00%,15.10%,9.50%,1332,291,409,143,0,843,28,66,66,0,160,1332,285,398,140,0,823,30,71,63,0,164
Putnam,107,33.60%,12.70%,14.00%,32.20%,12.40%,14.50%,4293,535,1470,574,0,2579,87,214,290,0,591,4293,532,1467,561,0,2560,90,207,266,0,563
Quitman,G,61.90%,35.80%,50.70%,57.80%,34.70%,50.40%,1454,142,343,80,0,565,145,191,130,1,467,1454,137,342,86,0,565,138,182,118,1,439
Quitman,M,46.70%,33.30%,46.20%,50.00%,46.20%,46.20%,93,21,10,8,0,39,18,5,7,0,30,93,21,7,7,0,35,18,6,7,0,31
Rabun,RABUN,34.80%,16.30%,14.20%,32.50%,15.60%,13.90%,13072,1207,4604,1663,0,7474,199,897,888,0,1984,13072,1167,4573,1652,0,7392,188,843,794,0,1825
Randolph,131,46.70%,44.60%,50.90%,45.20%,40.20%,47.40%,229,28,46,16,0,90,28,37,14,1,80,229,30,49,17,0,96,26,33,14,1,74
Randolph,334,64.30%,34.40%,51.30%,62.00%,33.10%,50.00%,929,136,166,56,0,358,142,87,101,1,331,929,139,166,57,0,362,138,82,93,1,314
Randolph,566,47.10%,22.60%,34.80%,41.20%,21.10%,40.40%,354,58,103,18,0,179,31,30,16,0,77,354,53,105,20,0,178,36,28,14,0,78
Randolph,718A,68.90%,47.70%,62.80%,67.20%,46.80%,62.20%,2253,74,504,112,0,690,125,460,248,0,833,2253,73,506,114,0,693,120,446,234,0,800
Randolph,718B,95.70%,95.60%,94.30%,97.70%,91.20%,90.60%,323,3,6,2,0,11,49,130,45,1,225,323,5,12,1,0,18,47,125,42,1,215
Randolph,954,80.00%,65.20%,55.10%,83.30%,67.10%,57.10%,253,22,31,10,0,63,27,58,40,0,125,253,21,28,8,0,57,28,57,40,0,125
Richmond,101,69.80%,55.60%,38.00%,67.40%,54.10%,38.30%,896,115,120,58,1,294,69,150,134,2,355,896,112,123,61,1,297,70,145,126,0,341
Richmond,102,81.40%,73.00%,70.10%,79.80%,70.10%,70.20%,1278,56,62,42,0,160,128,168,184,3,483,1278,54,66,41,0,161,124,155,162,3,444
Richmond,103,98.30%,95.30%,96.40%,95.10%,95.10%,96.90%,1428,6,15,5,0,26,160,302,288,2,752,1428,5,15,13,0,33,156,293,255,2,706
Richmond,104,94.60%,91.20%,94.50%,92.20%,89.60%,93.80%,2976,25,51,33,0,109,427,529,578,6,1540,2976,28,59,45,0,132,417,508,530,6,1461
Richmond,105,94.50%,93.00%,94.30%,93.70%,92.60%,92.50%,832,7,17,10,0,34,114,225,171,1,511,832,9,17,11,0,37,110,214,163,1,488
Richmond,106,80.20%,68.60%,77.10%,75.50%,65.60%,77.80%,1182,43,50,32,0,125,143,109,130,2,384,1182,40,53,36,0,129,138,101,111,2,352
Richmond,107,68.60%,50.70%,41.80%,65.50%,49.00%,42.30%,1800,184,255,139,0,578,131,262,303,1,697,1800,180,264,148,0,592,131,254,281,1,667
Richmond,108,93.00%,88.60%,77.60%,85.40%,88.40%,77.60%,517,17,14,9,0,40,59,109,119,0,287,517,17,14,18,0,49,59,107,105,0,271
Richmond,109,87.00%,84.90%,77.50%,84.50%,83.30%,78.00%,1052,29,43,26,0,98,99,241,174,1,515,1052,28,46,29,0,103,98,230,158,1,487
Richmond,111,85.20%,76.40%,75.10%,85.40%,74.20%,74.20%,1578,56,80,48,0,184,168,259,276,1,704,1578,57,85,45,0,187,163,245,264,1,673
Richmond,112,62.40%,60.80%,67.60%,58.80%,59.60%,71.00%,882,22,83,97,0,202,44,129,161,2,336,882,18,84,98,0,200,42,124,140,2,308
Richmond,114,88.80%,88.40%,84.30%,88.90%,90.70%,79.80%,856,21,18,17,0,56,112,137,135,1,385,856,26,14,17,0,57,102,136,136,1,375
Richmond,115,96.20%,97.20%,93.60%,95.50%,96.00%,92.40%,581,16,8,9,1,34,246,273,226,4,749,581,20,11,10,0,41,238,267,212,4,721
Richmond,201,70.70%,52.90%,49.40%,67.90%,53.40%,52.30%,1332,43,41,24,0,108,42,46,58,0,146,1332,41,41,25,0,107,45,47,53,0,145
Richmond,202,71.10%,71.90%,70.10%,70.70%,70.90%,69.80%,4492,217,290,220,0,727,499,741,541,9,1790,4492,211,293,210,1,715,482,714,507,8,1711
Richmond,203,99.00%,97.30%,97.30%,97.40%,96.00%,93.90%,991,4,5,2,0,11,140,179,204,3,526,991,6,7,5,3,21,139,169,188,0,496
Richmond,204,60.80%,54.30%,41.00%,59.70%,53.20%,39.20%,1578,176,209,124,1,510,122,248,192,1,563,1578,176,211,123,1,511,113,240,182,1,536
Richmond,207,89.90%,89.60%,87.30%,88.90%,88.30%,83.90%,2705,52,52,46,1,151,358,448,408,7,1221,2705,64,57,47,2,170,337,430,377,6,1150
Richmond,208,86.80%,83.30%,78.90%,84.70%,81.80%,79.80%,2651,82,98,60,1,241,307,489,393,3,1192,2651,76,103,66,2,247,306,464,365,2,1137
Richmond,210,90.00%,83.00%,77.50%,89.40%,83.50%,79.40%,1507,44,65,39,1,149,152,317,351,3,823,1507,39,61,40,1,141,151,308,336,3,798
Richmond,301,53.60%,35.90%,29.70%,49.60%,33.50%,27.40%,2409,323,562,268,1,1154,136,315,309,1,761,2409,336,584,282,1,1203,127,294,278,0,699
Richmond,302,76.30%,76.20%,81.50%,73.10%,74.10%,80.50%,1032,31,66,38,0,135,137,211,122,0,470,1032,32,70,42,0,144,132,200,114,0,446
Richmond,303,48.10%,26.80%,16.60%,43.20%,22.60%,13.10%,1417,160,439,179,1,779,32,161,166,0,359,1417,171,466,188,1,826,26,136,143,0,305
Richmond,304,54.50%,44.60%,20.00%,48.90%,36.40%,17.60%,365,56,62,40,0,158,14,50,48,0,112,365,56,70,45,0,171,12,40,43,0,95
Richmond,305,37.60%,22.30%,18.20%,29.30%,18.30%,12.70%,428,44,153,78,1,276,10,44,47,0,101,428,47,161,87,1,296,7,36,36,0,79
Richmond,306,68.20%,68.80%,55.40%,65.90%,67.80%,57.20%,3934,221,378,268,0,867,271,833,574,3,1681,3934,211,387,271,0,869,279,816,524,3,1622
Richmond,307,56.90%,34.30%,27.00%,52.50%,31.60%,26.90%,1642,176,360,166,0,702,65,188,219,0,472,1642,179,375,181,0,735,66,173,200,0,439
Richmond,308,65.80%,60.80%,53.80%,64.90%,61.10%,51.10%,622,42,69,41,0,152,48,107,79,1,235,622,45,68,39,0,152,47,107,72,0,226
Richmond,309,90.20%,89.00%,76.40%,88.90%,88.60%,77.60%,3340,91,135,80,1,307,296,1097,740,2,2135,3340,85,139,88,1,313,296,1081,707,2,2086
Richmond,310,84.50%,78.20%,62.00%,84.50%,78.20%,63.80%,5163,242,379,179,1,801,393,1363,976,4,2736,5163,229,378,171,1,779,402,1356,931,4,2693
Richmond,401,95.90%,94.10%,88.90%,94.90%,93.00%,87.50%,2093,29,44,21,0,94,232,701,491,0,1424,2093,32,52,25,0,109,225,686,465,0,1376
Richmond,402,91.50%,88.80%,85.50%,90.90%,87.30%,84.70%,3311,72,67,50,0,189,419,531,541,4,1495,3311,74,75,51,0,200,406,517,507,4,1434
Richmond,404,87.10%,89.80%,85.30%,87.30%,88.50%,84.70%,1748,39,52,50,1,142,229,459,339,3,1030,1748,40,58,47,0,145,219,447,322,3,991
Richmond,405,92.50%,92.50%,86.10%,92.50%,91.90%,86.20%,4424,56,118,90,0,264,341,1462,1109,5,2917,4424,54,126,87,0,267,333,1436,1072,4,2845
Richmond,406,92.60%,92.50%,84.60%,92.30%,92.10%,84.60%,3221,58,82,64,1,205,319,1007,800,4,2130,3221,58,85,64,1,208,321,994,764,4,2083
Richmond,501,87.90%,88.10%,85.10%,87.80%,86.60%,84.30%,3549,65,100,104,0,269,368,737,752,4,1861,3549,67,109,98,0,274,358,706,707,3,1774
Richmond,502,93.00%,90.90%,84.30%,92.60%,90.80%,83.60%,4138,87,96,66,0,249,458,958,872,8,2296,4138,90,95,67,0,252,451,942,834,7,2234
Richmond,503,90.30%,83.00%,80.00%,89.20%,82.00%,80.30%,4021,93,185,84,1,363,373,903,781,4,2061,4021,88,193,88,2,371,365,879,729,3,1976
Richmond,504,77.50%,77.40%,63.50%,77.80%,75.40%,63.70%,2339,142,107,85,2,336,246,366,293,4,909,2339,140,117,80,2,339,245,358,281,4,888
Richmond,506,79.60%,63.60%,75.00%,77.60%,64.50%,75.90%,416,14,44,11,0,69,39,77,43,3,162,416,14,43,11,0,68,41,78,38,3,160
Richmond,507,78.10%,75.60%,77.30%,75.00%,75.60%,76.10%,968,41,67,39,0,147,139,208,139,1,487,968,43,66,43,0,152,136,205,129,1,471
Richmond,509,88.40%,87.90%,78.50%,88.40%,88.20%,78.00%,2172,55,84,57,1,197,200,609,435,4,1248,2172,55,80,53,0,188,191,597,404,4,1196
Richmond,601,84.20%,75.50%,68.10%,82.00%,75.00%,67.30%,3988,157,258,104,4,523,330,795,555,13,1693,3988,158,257,112,3,530,318,772,510,14,1614
Richmond,603,61.60%,54.70%,43.40%,60.60%,53.30%,42.40%,3570,392,390,256,0,1038,298,470,411,2,1181,3570,394,398,252,0,1044,288,454,387,2,1131
Richmond,604,77.30%,78.90%,53.20%,75.90%,78.80%,52.90%,1811,163,83,67,0,313,185,311,228,0,724,1811,157,82,70,0,309,176,305,221,0,702
Richmond,605,73.10%,66.90%,57.30%,71.80%,66.00%,56.60%,3880,235,318,202,0,755,312,644,549,3,1508,3880,232,326,201,0,759,300,632,511,2,1445
Richmond,607,95.20%,93.70%,89.30%,93.80%,93.60%,88.90%,1812,23,36,21,0,80,190,536,417,2,1145,1812,23,36,26,1,86,191,525,392,1,1109
Richmond,608,57.90%,43.10%,27.10%,57.10%,41.60%,27.20%,1472,245,236,109,0,590,90,179,150,1,420,1472,241,241,105,0,587,89,172,140,1,402
Richmond,701,57.30%,33.80%,26.80%,53.70%,32.30%,25.50%,2403,303,546,238,0,1087,109,279,320,2,710,2403,309,557,253,1,1120,105,266,293,1,665
Richmond,702,56.20%,34.90%,27.90%,53.10%,35.00%,27.00%,1943,290,406,156,0,852,112,218,200,0,530,1943,286,402,161,0,849,106,216,182,0,504
Richmond,703,67.50%,57.50%,49.00%,64.90%,56.20%,48.50%,4644,364,576,249,0,1189,343,780,517,7,1647,4644,363,587,258,0,1208,335,752,478,7,1572
Richmond,705,49.90%,42.60%,37.70%,48.70%,42.60%,36.10%,2276,208,436,282,2,928,126,324,281,1,732,2276,210,433,284,2,929,119,321,270,1,711
Richmond,706,54.90%,34.20%,31.00%,51.30%,33.90%,31.00%,3315,251,863,337,0,1451,111,449,410,2,972,3315,245,865,348,0,1458,109,443,367,1,920
Richmond,707,70.70%,63.10%,55.90%,70.10%,62.10%,58.10%,2122,165,245,95,1,506,208,419,229,2,858,2122,157,246,89,1,493,217,403,209,2,831
Richmond,708,40.40%,28.10%,31.00%,36.00%,28.70%,26.70%,305,19,110,31,1,161,9,43,21,0,73,305,21,107,32,1,161,8,43,18,0,69
Richmond,709,64.70%,47.10%,41.30%,62.70%,43.90%,39.40%,576,44,101,49,0,194,31,90,90,0,211,576,43,106,50,0,199,28,83,84,0,195
Richmond,801,55.30%,35.60%,20.10%,54.90%,36.60%,19.10%,523,162,47,38,1,248,41,26,47,0,114,523,160,45,37,1,243,38,26,45,0,109
Richmond,801B,46.50%,28.90%,16.50%,43.80%,30.40%,17.00%,523,198,32,46,0,276,39,13,40,0,92,523,195,32,45,0,272,40,14,35,0,89
Richmond,802,60.60%,37.40%,18.10%,58.40%,37.60%,18.60%,3251,712,420,208,4,1344,156,251,320,2,729,3251,699,413,208,4,1324,159,249,292,2,702
Richmond,803,93.10%,56.30%,71.90%,92.90%,53.20%,75.80%,252,9,21,2,0,32,22,27,27,1,77,252,8,22,2,0,32,24,25,26,1,76
Richmond,804,73.50%,59.20%,42.20%,72.80%,59.30%,41.60%,2096,196,274,96,1,567,144,398,266,0,808,2096,195,268,94,0,557,139,390,252,0,781
Richmond,804H,63.10%,47.30%,32.10%,63.10%,47.60%,33.10%,2863,373,428,198,2,1001,175,384,339,2,900,2863,366,422,190,0,978,177,383,325,4,889
Richmond,805,84.30%,70.20%,52.60%,81.50%,70.00%,53.80%,798,63,81,22,0,166,69,191,118,1,379,798,61,80,25,0,166,70,187,110,1,368
Richmond,806,59.00%,41.20%,25.60%,58.80%,40.40%,26.40%,1212,215,200,80,0,495,73,140,115,1,329,1212,209,198,77,0,484,74,134,110,1,319
Richmond,807,83.60%,75.70%,61.80%,81.80%,75.00%,62.50%,1578,81,102,49,0,232,130,318,249,1,698,1578,78,102,52,0,232,129,306,233,1,669
Richmond,808,64.40%,49.30%,35.60%,64.20%,49.80%,35.70%,2366,299,379,165,0,843,164,369,298,1,832,2366,297,371,162,0,830,164,368,290,1,823
Richmond,809,94.60%,93.40%,87.10%,94.00%,94.50%,88.10%,879,12,22,11,0,45,79,311,194,2,586,879,10,18,12,0,40,72,309,189,2,572
Richmond,810,70.00%,41.10%,18.50%,68.80%,41.90%,20.60%,425,53,96,24,0,173,12,67,56,0,135,425,54,93,24,0,171,14,67,53,0,134
Rockdale,BA,70.70%,62.60%,52.40%,69.90%,62.70%,53.50%,4803,228,773,273,0,1274,250,1294,659,1,2204,4803,219,766,269,0,1254,251,1287,624,1,2163
Rockdale,BT,55.00%,40.20%,26.10%,54.30%,40.70%,27.80%,4007,463,818,315,4,1600,164,549,385,1,1099,4007,456,800,308,3,1567,176,548,366,1,1091
Rockdale,CO,80.30%,80.20%,73.90%,80.30%,79.90%,73.00%,3862,101,239,111,2,453,290,969,453,2,1714,3862,105,239,106,2,452,287,950,431,2,1670
Rockdale,FI,87.50%,85.70%,81.10%,87.30%,85.90%,83.30%,6328,84,364,161,0,609,360,2181,1130,1,3672,6328,73,354,155,0,582,365,2164,1066,0,3595
Rockdale,FS,79.70%,80.60%,72.00%,79.00%,80.40%,71.60%,4038,85,312,174,0,571,219,1296,683,0,2198,4038,84,313,174,0,571,212,1281,653,0,2146
Rockdale,HC,65.00%,54.50%,45.70%,62.40%,54.00%,46.50%,2411,145,454,163,0,762,122,543,303,0,968,2411,139,454,168,0,761,121,534,279,0,934
Rockdale,HI,73.90%,64.80%,53.70%,74.20%,65.20%,56.00%,3515,139,524,172,0,835,161,963,487,0,1611,3515,129,511,165,0,805,164,959,475,0,1598
Rockdale,LA,77.30%,70.00%,59.10%,78.40%,69.40%,60.30%,2001,81,169,101,0,351,117,395,343,0,855,2001,79,170,91,0,340,120,385,331,0,836
Rockdale,LO,71.50%,61.80%,37.70%,70.30%,62.20%,37.10%,3943,348,615,236,1,1200,211,994,593,0,1798,3943,352,607,240,1,1200,208,997,567,0,1772
Rockdale,MA,65.50%,56.30%,40.60%,64.00%,56.30%,41.40%,3180,230,528,204,0,962,156,681,388,1,1226,3180,225,525,201,0,951,158,677,357,1,1193
Rockdale,MI,83.30%,78.60%,69.60%,82.00%,79.10%,72.50%,4226,109,329,119,0,557,245,1209,595,5,2054,4226,95,318,124,0,537,246,1202,565,5,2018
Rockdale,OT,83.40%,85.60%,85.10%,82.60%,86.10%,86.60%,6135,69,309,174,1,553,394,1831,877,5,3107,6135,61,292,173,1,527,396,1805,823,4,3028
Rockdale,RO,77.40%,73.60%,66.00%,78.30%,73.80%,68.40%,4633,131,504,199,0,834,252,1404,681,2,2339,4633,121,494,181,0,796,260,1392,653,2,2307
Rockdale,SM,79.30%,74.70%,67.70%,78.60%,74.60%,68.20%,4308,96,487,178,2,763,200,1440,681,5,2326,4308,92,483,178,2,755,199,1421,652,3,2275
Rockdale,SP,78.70%,77.80%,72.10%,78.30%,77.90%,74.80%,4781,100,470,187,2,759,264,1647,689,0,2600,4781,88,463,182,2,735,267,1631,657,0,2555
Rockdale,ST,66.90%,59.90%,53.70%,66.50%,60.90%,58.50%,3334,117,571,238,3,929,138,852,482,1,1473,3334,100,546,234,3,883,144,850,465,1,1460
Schley,1,50.50%,15.20%,17.60%,48.00%,15.00%,17.20%,2882,304,1341,154,1,1800,65,240,157,0,462,2882,303,1325,154,1,1783,63,234,142,0,439
Screven,1,56.30%,41.70%,46.00%,52.10%,40.80%,46.00%,0,74,266,93,0,433,62,190,120,1,373,0,74,267,101,0,442,62,184,110,1,357
Screven,2,62.00%,34.00%,21.80%,51.90%,35.30%,23.00%,0,89,101,30,8,228,26,52,49,1,128,0,88,99,37,6,230,26,54,40,2,122
Screven,3,57.00%,33.40%,24.30%,56.80%,33.40%,25.80%,0,230,227,49,0,506,74,114,65,0,253,0,221,223,48,0,492,77,112,63,0,252
Screven,4,66.00%,47.70%,45.80%,65.20%,47.80%,46.60%,0,95,235,55,1,386,81,214,107,0,402,0,93,233,54,1,381,82,213,101,0,396
Screven,5,41.10%,20.70%,15.20%,39.40%,20.50%,15.40%,0,112,138,43,0,293,20,36,30,0,86,0,110,136,43,0,289,20,35,28,0,83
Screven,6,30.70%,14.80%,7.00%,27.40%,15.60%,8.00%,0,199,345,61,1,606,15,60,27,0,102,0,194,335,61,1,591,17,62,23,0,102
Screven,7,75.70%,36.30%,48.60%,74.50%,37.10%,47.40%,0,90,211,26,0,327,85,120,81,0,286,0,92,207,27,0,326,83,122,79,0,284
Screven,8,77.30%,44.70%,53.30%,75.00%,43.50%,51.90%,0,35,78,15,0,128,37,63,51,3,154,0,37,78,16,0,131,37,60,48,3,148
Screven,9,48.50%,19.10%,17.80%,46.90%,19.30%,19.40%,0,166,262,51,0,479,36,62,48,0,146,0,162,259,52,0,473,39,62,46,0,147
Screven,10,72.10%,61.20%,73.00%,69.30%,60.20%,72.80%,0,47,167,50,0,264,127,263,129,0,519,0,47,171,51,0,269,126,259,115,0,500
Screven,11,62.90%,23.60%,16.00%,56.90%,22.30%,13.00%,0,105,81,23,0,209,20,25,39,0,84,0,107,80,25,0,212,16,23,33,0,72
Screven,12,82.70%,69.10%,51.30%,82.70%,69.10%,48.60%,0,18,29,9,1,57,18,65,43,2,128,0,18,29,9,1,57,16,65,43,2,126
Seminole,1,41.70%,24.70%,16.70%,42.40%,23.80%,17.80%,1292,224,365,70,0,659,45,120,50,0,215,1292,217,361,68,0,646,47,113,50,0,210
Seminole,2,50.90%,31.70%,30.30%,43.00%,30.90%,27.70%,1122,101,336,55,0,492,44,156,57,0,257,1122,102,336,57,0,495,39,150,43,0,232
Seminole,3,95.30%,85.60%,79.50%,89.60%,81.90%,77.10%,1174,34,50,5,0,89,132,297,101,0,530,1174,39,62,10,0,111,131,281,86,0,498
Seminole,4,29.40%,21.10%,15.90%,30.90%,20.10%,15.50%,1121,248,311,60,0,619,47,83,25,0,155,1121,246,310,56,0,612,45,78,25,0,148
Seminole,5,29.30%,9.60%,7.20%,30.40%,9.80%,8.10%,1227,337,328,87,0,752,26,35,36,0,97,1227,330,323,80,0,733,29,35,35,0,99
Spalding,1,88.50%,85.40%,81.40%,89.20%,85.90%,83.90%,2260,56,49,37,10,152,250,286,285,38,859,2260,47,46,32,8,133,248,280,264,38,830
Spalding,2,93.00%,85.40%,85.90%,93.30%,87.30%,86.70%,1956,40,47,21,8,116,276,274,278,16,844,1956,35,40,19,9,103,271,276,264,15,826
Spalding,3,39.30%,23.60%,24.50%,36.20%,22.60%,23.20%,2774,241,833,298,144,1516,69,257,193,56,575,2774,243,840,302,147,1532,68,245,171,50,534
Spalding,5,62.30%,54.40%,58.80%,61.00%,54.20%,58.10%,3715,163,442,201,69,875,237,527,332,94,1190,3715,165,432,198,68,863,231,512,310,92,1145
Spalding,6,80.50%,72.10%,78.70%,80.60%,72.50%,79.50%,2438,62,143,76,11,292,254,370,313,15,952,2438,58,137,72,11,278,253,361,300,14,928
Spalding,7,35.50%,25.20%,18.50%,32.20%,23.70%,18.00%,1705,316,451,182,15,964,71,152,100,4,327,1705,313,458,185,16,972,68,142,88,4,302
Spalding,8,38.90%,23.60%,25.60%,36.00%,22.10%,26.40%,1789,255,476,190,18,939,87,147,121,7,362,1789,255,482,190,15,942,90,137,107,7,341
Spalding,9,28.80%,12.90%,11.50%,29.80%,12.90%,12.10%,1950,375,512,193,26,1106,46,76,78,6,206,1950,370,500,181,24,1075,47,74,77,7,205
Spalding,10,49.50%,32.60%,35.40%,49.10%,33.10%,34.80%,1981,272,471,158,9,910,139,228,155,15,537,1981,275,467,146,8,896,135,231,141,16,523
Spalding,11,54.40%,29.40%,28.10%,54.50%,29.50%,29.20%,2506,414,597,164,20,1195,159,249,196,11,615,2506,406,593,158,20,1177,166,248,189,10,613
Spalding,12,34.60%,15.30%,10.30%,33.80%,15.50%,11.80%,2163,444,621,214,27,1306,51,112,113,3,279,2163,430,612,210,27,1279,59,112,107,2,280
Spalding,13,26.10%,15.20%,9.10%,24.10%,15.70%,10.30%,2586,574,599,226,46,1445,56,107,80,6,249,2586,560,587,217,42,1406,62,109,69,7,247
Spalding,14,43.50%,29.70%,25.60%,43.60%,28.60%,26.70%,1985,366,291,140,20,817,126,123,108,7,364,1985,348,289,133,19,789,128,116,103,6,353
Spalding,16,76.90%,61.60%,65.30%,77.40%,62.00%,65.90%,4596,184,445,196,24,849,338,713,651,53,1755,4596,177,430,183,22,812,332,703,627,52,1714
Spalding,17,58.60%,28.10%,29.10%,60.90%,28.60%,30.30%,2011,259,383,94,19,755,106,150,133,8,397,2011,249,375,81,20,725,110,150,126,7,393
Spalding,19,40.80%,25.20%,25.00%,40.10%,24.60%,26.10%,2664,398,668,252,16,1334,129,225,174,9,537,2664,388,661,243,14,1306,133,216,163,9,521
Spalding,20,35.50%,12.80%,10.60%,32.70%,13.10%,9.90%,2190,469,593,169,21,1252,53,87,93,5,238,2190,460,583,165,20,1228,49,88,80,4,221
Spalding,21,55.90%,30.50%,24.20%,52.50%,29.50%,23.10%,4716,346,1180,679,29,2234,107,517,861,13,1498,4716,339,1188,698,27,2252,100,498,771,10,1379
Stephens,SC1,37.10%,16.00%,19.00%,33.30%,15.20%,19.30%,0,1234,6765,1365,4,9368,291,1288,806,0,2385,0,1204,6766,1379,4,9353,289,1211,687,0,2187
Stewart,2,81.10%,45.10%,58.20%,78.00%,45.70%,59.90%,1256,89,208,48,0,345,118,171,206,6,501,1256,83,200,54,0,337,118,168,192,6,484
Stewart,4,68.00%,61.30%,55.20%,67.30%,60.70%,56.30%,286,42,24,16,1,83,53,38,34,0,125,286,41,24,16,1,82,54,37,33,0,124
Stewart,5,80.00%,57.60%,57.40%,76.00%,54.60%,54.70%,1134,50,209,31,2,292,69,284,124,1,478,1134,51,215,35,2,303,63,259,111,1,434
Stewart,6,58.30%,36.40%,51.00%,54.20%,41.90%,47.50%,217,48,21,10,2,81,52,12,14,0,78,217,50,18,11,2,81,47,13,13,0,73
Sumter,15,65.60%,30.30%,24.90%,62.10%,29.50%,25.60%,1687,298,395,76,1,770,98,172,145,1,416,1687,293,392,83,1,769,100,164,136,1,401
Sumter,17,61.20%,51.70%,38.30%,59.10%,50.80%,39.40%,712,103,86,38,0,227,63,92,60,1,216,712,100,87,38,0,225,64,90,55,1,210
Sumter,28,59.70%,26.80%,24.00%,61.30%,26.80%,23.60%,929,138,276,50,1,465,44,101,74,0,219,929,138,273,48,1,460,43,100,76,0,219
Sumter,29,54.90%,27.40%,14.70%,54.20%,30.70%,17.60%,434,162,82,23,1,268,28,31,28,0,87,434,158,79,22,1,260,34,35,26,0,95
Sumter,C1-27,84.00%,75.60%,78.80%,82.40%,75.30%,79.00%,3064,63,222,83,0,368,234,686,437,0,1357,3064,62,221,89,0,372,233,675,417,0,1325
Sumter,C2-27,56.10%,43.10%,50.20%,53.70%,42.00%,49.60%,3044,134,736,221,0,1091,133,558,282,2,975,3044,134,745,225,0,1104,130,540,261,2,933
Sumter,C3-27,88.60%,80.00%,81.50%,89.90%,77.30%,80.40%,2667,56,178,62,0,296,245,710,481,1,1437,2667,58,198,53,0,309,237,673,471,1,1382
Sumter,E-27,62.40%,41.40%,39.50%,59.90%,40.60%,39.50%,1767,130,486,112,0,728,85,343,186,0,614,1767,127,491,115,0,733,83,336,172,0,591
Sumter,N-26,27.30%,21.80%,6.00%,33.30%,19.80%,4.90%,376,148,79,24,9,260,10,22,9,0,41,376,146,81,20,8,255,8,20,10,0,38
Sumter,O-26,68.80%,40.50%,46.70%,69.10%,41.10%,44.60%,1061,143,200,53,1,397,126,136,117,0,379,1061,147,195,51,1,394,119,136,114,0,369
Sumter,W-27,68.20%,32.60%,33.20%,66.70%,31.70%,32.90%,2059,149,618,95,0,862,73,299,204,1,577,2059,147,619,96,0,862,71,287,192,1,551
Talbot,1,80.50%,47.50%,50.80%,80.50%,46.90%,50.40%,555,61,104,24,0,189,63,94,99,0,256,555,59,102,23,0,184,60,90,95,0,245
Talbot,2,71.00%,36.70%,51.10%,67.90%,36.40%,48.00%,688,85,138,49,0,272,89,80,120,0,289,688,90,140,52,0,282,83,80,110,0,273
Talbot,3,84.60%,39.10%,52.30%,85.70%,40.40%,57.60%,437,42,56,22,0,120,46,36,121,0,203,437,36,53,18,0,107,49,36,108,0,193
Talbot,4,78.30%,39.40%,48.40%,75.30%,42.10%,49.50%,482,46,77,34,1,158,44,50,123,0,217,482,45,73,36,1,155,45,53,110,0,208
Talbot,5,86.00%,74.00%,81.80%,83.20%,72.30%,77.60%,884,25,60,38,0,123,112,171,234,0,517,884,30,64,41,0,135,104,167,203,0,474
Talbot,6,77.00%,36.30%,26.50%,79.30%,35.20%,27.00%,469,122,58,20,0,200,44,33,67,0,144,469,119,57,17,0,193,44,31,65,0,140
Talbot,8,78.00%,44.40%,63.30%,77.50%,44.60%,62.40%,1048,83,193,54,0,330,143,154,191,0,488,1048,86,191,53,0,330,143,154,183,0,480
Taliaferro,172,90.20%,54.70%,47.10%,86.70%,54.70%,46.40%,253,37,29,5,0,71,32,35,46,1,114,253,37,29,6,0,72,32,35,39,0,106
Taliaferro,601,76.40%,52.40%,53.50%,74.00%,51.00%,51.20%,992,59,171,59,0,289,68,188,191,0,447,992,62,172,60,0,294,65,179,171,0,415
Tattnall,1,27.70%,15.30%,17.50%,28.60%,16.60%,17.70%,761,207,161,68,0,436,44,29,26,0,99,761,200,156,65,0,421,43,31,26,0,100
Tattnall,10,51.10%,31.10%,24.20%,43.00%,31.80%,27.10%,1111,91,233,46,0,370,29,105,48,0,182,1111,86,225,49,0,360,32,105,37,0,174
Tattnall,3,45.40%,19.70%,13.70%,44.20%,19.50%,15.70%,1482,196,498,89,0,783,31,122,74,0,227,1482,188,484,86,0,758,35,117,68,0,220
Tattnall,4,55.00%,23.50%,22.10%,60.00%,23.80%,20.90%,265,74,62,9,0,145,21,19,11,0,51,265,72,61,8,0,141,19,19,12,0,50
Tattnall,5,45.70%,30.90%,31.40%,46.00%,29.60%,31.80%,2500,199,747,127,0,1073,91,334,107,0,532,2500,191,746,121,0,1058,89,313,103,0,505
Tattnall,7,31.30%,18.00%,17.90%,28.90%,18.00%,17.60%,2506,289,872,244,0,1405,63,191,111,0,365,2506,285,867,246,0,1398,61,190,100,0,351
Tattnall,8,48.20%,23.50%,31.00%,47.80%,22.50%,30.90%,2497,263,799,159,0,1221,118,246,148,0,512,2497,260,792,154,0,1206,116,230,141,0,487
Tattnall,9,21.60%,14.80%,6.50%,21.90%,13.90%,7.50%,1062,217,327,76,0,620,15,57,21,0,93,1062,210,327,75,0,612,17,53,21,0,91
Taylor,1,92.00%,76.40%,86.40%,88.10%,74.60%,85.00%,1108,19,86,13,1,119,126,279,149,1,555,1108,21,90,18,1,130,124,265,133,1,523
Taylor,5,32.20%,11.10%,21.90%,30.90%,10.10%,22.60%,2219,174,1028,154,8,1364,50,128,73,1,252,2219,170,1014,150,8,1342,51,114,67,1,233
Taylor,6,68.10%,25.00%,37.50%,65.90%,24.50%,38.30%,2073,156,650,125,4,935,96,217,267,0,580,2073,155,639,130,3,927,98,207,251,0,556
Telfair,HE,58.90%,26.60%,33.90%,52.80%,26.80%,33.30%,969,116,282,37,3,438,56,102,53,5,216,969,112,271,42,2,427,52,99,47,5,203
Telfair,JA,43.20%,16.10%,16.70%,48.00%,16.90%,17.30%,628,180,125,46,0,351,35,24,35,1,95,628,172,118,39,0,329,35,24,36,1,96
Telfair,LU,81.70%,20.50%,28.90%,82.30%,18.90%,30.40%,963,162,174,50,0,386,66,45,223,0,334,963,158,176,47,0,381,69,41,219,0,329
Telfair,MC,65.80%,35.70%,42.00%,63.90%,36.60%,42.50%,2337,149,602,142,0,893,107,334,273,1,715,2337,145,579,143,0,867,106,334,253,1,694
Telfair,MI,25.60%,7.50%,10.90%,18.80%,9.00%,10.00%,802,244,247,67,0,558,30,20,23,0,73,802,242,244,69,0,555,27,24,16,0,67
Telfair,SC,40.70%,20.80%,17.70%,30.40%,20.70%,16.30%,333,107,76,16,0,199,23,20,11,0,54,333,103,73,16,0,192,20,19,7,0,46
Terrell,1,84.80%,69.60%,79.70%,83.50%,67.00%,76.20%,3043,79,270,90,0,439,311,619,504,0,1434,3043,92,290,95,0,477,295,589,482,0,1366
Terrell,2,58.20%,26.70%,29.60%,57.10%,25.80%,29.40%,1355,178,393,66,0,637,75,143,92,0,310,1355,180,392,66,0,638,75,136,88,0,299
Terrell,3,73.00%,40.90%,34.70%,72.50%,38.10%,35.30%,885,124,150,41,0,315,66,104,111,0,281,885,121,156,41,0,318,66,96,108,0,270
Terrell,4,68.50%,25.50%,30.80%,68.00%,26.60%,30.80%,412,119,70,17,0,206,53,24,37,0,114,412,117,69,16,0,202,52,25,34,0,111
Terrell,5,60.00%,28.20%,21.10%,59.40%,27.80%,19.90%,598,112,135,42,0,289,29,53,63,1,146,598,113,135,41,0,289,27,52,60,1,140
Terrell,6,69.60%,33.80%,38.40%,70.20%,33.30%,38.80%,301,53,51,14,0,118,33,26,32,0,91,301,52,50,14,0,116,33,25,33,0,91
Thomas,101,33.90%,16.70%,23.80%,31.70%,15.40%,20.50%,630,125,214,41,0,380,39,43,21,0,103,630,124,214,41,0,379,32,39,19,0,90
Thomas,102,66.40%,42.10%,45.70%,65.50%,41.10%,42.80%,1632,150,363,79,0,592,126,264,156,0,546,1632,155,360,76,0,591,116,251,144,0,511
Thomas,103,51.70%,28.30%,31.20%,50.00%,27.10%,29.50%,3523,189,1291,238,1,1719,86,509,255,0,850,3523,188,1293,236,1,1718,79,480,236,0,795
Thomas,104,41.20%,16.60%,23.00%,41.50%,16.50%,22.30%,983,218,286,57,0,561,65,57,40,0,162,983,212,284,55,0,551,61,56,39,0,156
Thomas,105,87.00%,80.90%,80.90%,85.00%,78.70%,80.50%,2448,54,169,40,0,263,228,715,268,0,1211,2448,53,184,41,0,278,219,679,232,0,1130
Thomas,106,33.90%,21.60%,8.40%,29.40%,20.70%,8.20%,1132,206,446,78,0,730,19,123,40,0,182,1132,201,447,77,0,725,18,117,32,0,167
Thomas,107,47.00%,26.60%,12.20%,42.60%,24.20%,10.00%,1404,130,546,122,0,798,18,198,108,0,324,1404,135,557,128,0,820,15,178,95,0,288
Thomas,108,45.20%,22.80%,20.40%,41.70%,21.20%,17.60%,2069,207,808,142,0,1157,53,238,117,0,408,2069,210,813,144,0,1167,45,219,103,0,367
Thomas,109,86.80%,71.60%,80.40%,86.20%,69.30%,75.80%,2001,38,217,45,0,300,156,546,297,0,999,2001,45,232,44,0,321,141,523,274,0,938
Thomas,110,51.40%,34.70%,45.00%,45.70%,32.10%,40.40%,1898,93,631,159,0,883,76,336,168,0,580,1898,99,652,172,0,923,67,308,145,0,520
Thomas,111,43.20%,26.50%,52.00%,44.30%,25.10%,51.50%,864,134,164,46,0,344,144,59,35,1,239,864,132,167,44,0,343,139,56,35,1,231
Thomas,112,63.40%,23.70%,17.20%,68.30%,26.40%,16.10%,299,77,71,15,0,163,16,22,26,0,64,299,78,67,13,0,158,15,24,28,0,67
Thomas,113,51.20%,22.40%,18.50%,50.20%,21.80%,19.80%,2155,225,816,119,0,1160,51,236,125,0,412,2155,219,815,117,0,1151,54,227,118,0,399
Thomas,114,30.70%,16.00%,17.50%,31.90%,16.10%,17.40%,1175,269,363,52,0,684,56,69,23,1,149,1175,262,360,47,0,669,54,69,22,1,146
Thomas,115,50.60%,14.80%,9.40%,48.10%,14.40%,9.00%,673,184,178,39,0,401,19,31,40,0,90,673,182,178,40,0,400,18,30,37,0,85
Thomas,116,50.60%,36.80%,34.10%,47.90%,36.00%,35.20%,2190,145,653,175,0,973,75,381,179,0,635,2190,138,650,170,0,958,75,365,156,0,596
Thomas,117,95.20%,89.40%,94.60%,93.80%,86.10%,93.20%,1363,8,51,12,0,71,140,431,240,0,811,1363,10,65,15,0,90,137,404,228,0,769
Thomas,118,57.50%,34.40%,39.10%,57.20%,33.60%,39.00%,2491,120,878,158,0,1156,75,461,214,2,752,2491,119,887,152,0,1158,74,449,203,2,728
Thomas,119,57.80%,20.20%,21.00%,56.60%,19.60%,20.30%,701,64,269,35,0,368,17,68,48,0,133,701,63,270,33,0,366,16,66,43,0,125
Thomas,120,40.00%,17.50%,14.60%,33.30%,15.60%,12.60%,397,82,151,18,0,251,14,32,12,0,58,397,83,151,20,0,254,12,28,10,0,50
Tift,1,50.90%,34.60%,41.50%,45.00%,32.90%,41.00%,3332,210,886,191,4,1291,144,468,198,8,818,3332,204,889,203,6,1302,140,436,166,6,748
Tift,2,39.20%,14.60%,10.20%,36.40%,14.00%,8.70%,2219,335,996,149,0,1480,38,170,96,0,304,2219,337,997,152,0,1486,32,162,87,0,281
Tift,3,41.50%,12.00%,13.40%,39.40%,11.80%,13.30%,1501,309,511,62,0,882,48,70,44,0,162,1501,299,508,60,0,867,46,68,39,0,153
Tift,4,32.90%,15.70%,5.40%,31.80%,15.30%,7.20%,1314,315,479,104,1,899,18,89,51,0,158,1314,310,476,103,1,890,24,86,48,0,158
Tift,5,28.70%,9.00%,5.60%,27.20%,8.10%,6.70%,1056,237,436,82,1,756,14,43,33,0,90,1056,234,434,83,1,752,17,38,31,0,86
Tift,6,24.20%,11.80%,10.40%,18.70%,11.00%,10.60%,1262,284,417,69,1,771,33,56,22,0,111,1262,277,422,74,1,774,33,52,17,0,102
Tift,7,38.50%,23.30%,22.40%,42.30%,20.70%,19.30%,864,238,132,32,1,403,69,40,20,0,129,864,241,134,30,1,406,58,35,22,0,115
Tift,8,38.10%,20.40%,25.20%,31.70%,18.20%,22.50%,1221,243,331,65,1,640,82,85,40,0,207,1221,247,336,69,1,653,72,75,32,0,179
Tift,9,45.90%,24.90%,32.50%,45.00%,24.00%,31.60%,3334,262,1176,199,0,1637,126,390,169,0,685,3334,257,1175,197,0,1629,119,371,161,0,651
Tift,10,84.00%,54.90%,72.50%,80.60%,54.40%,71.00%,2366,70,293,46,0,409,181,356,242,4,783,2366,71,294,54,0,419,170,351,225,4,750
Tift,11,92.30%,73.50%,87.40%,90.40%,72.00%,85.30%,2889,36,207,29,0,272,246,575,350,3,1174,2889,41,213,33,0,287,234,549,310,3,1096
Tift,12,50.80%,28.70%,38.10%,46.80%,27.30%,36.00%,3091,182,969,193,0,1344,111,390,199,1,701,3091,185,975,189,0,1349,103,367,166,1,637
Toombs,15361,41.90%,20.50%,30.00%,40.60%,19.90%,31.60%,0,306,1095,255,0,1656,130,282,184,1,597,0,297,1083,249,0,1629,136,269,170,1,576
Toombs,39,37.30%,5.90%,3.20%,34.90%,6.20%,5.30%,0,329,506,111,0,946,11,32,66,0,109,0,321,499,112,0,932,18,33,60,0,111
Toombs,43,16.50%,4.80%,7.30%,16.90%,5.10%,7.50%,0,345,452,111,0,908,26,23,22,1,72,0,343,444,108,0,895,27,24,22,1,74
Toombs,513,50.40%,24.30%,31.80%,48.60%,23.60%,31.10%,0,484,1746,475,4,2709,227,561,482,1,1271,0,484,1749,471,4,2708,219,541,445,1,1206
Toombs,514,55.00%,27.00%,34.40%,54.80%,26.90%,34.70%,0,333,1053,265,2,1653,175,390,324,1,890,0,333,1045,251,0,1629,174,384,304,3,865
Towns,833,38.40%,17.90%,14.30%,36.70%,17.00%,13.40%,3323,372,1179,371,1,1923,61,257,231,1,550,3323,367,1175,359,1,1902,56,240,208,1,505
Towns,990,35.20%,12.40%,8.60%,34.00%,12.20%,10.70%,3828,337,1540,419,3,2299,32,217,228,0,477,3828,322,1517,414,3,2256,39,211,213,0,463
Towns,1468,36.60%,14.50%,8.20%,35.50%,13.30%,9.40%,3542,275,1446,437,4,2162,25,246,252,0,523,3542,266,1437,426,4,2133,28,221,234,0,483
Treutlen,ANNEX,21.80%,8.20%,3.40%,19.20%,8.60%,4.70%,0,257,882,161,0,1300,9,79,45,0,133,0,244,866,160,0,1270,12,82,38,0,132
Treutlen,SOPE,69.50%,45.90%,41.50%,65.80%,44.50%,39.90%,0,161,527,113,0,801,114,447,258,0,819,0,161,527,120,0,808,107,423,231,0,761
Troup,1,37.20%,22.70%,21.80%,32.10%,21.10%,19.60%,3554,441,1128,427,1,1997,121,331,253,2,707,3554,449,1153,449,1,2052,108,308,212,2,630
Troup,2,76.10%,62.60%,71.90%,75.70%,61.10%,69.80%,3907,149,354,138,4,645,386,593,439,5,1423,3907,157,366,133,3,659,366,575,414,4,1359
Troup,3,68.10%,59.60%,63.00%,67.10%,58.80%,61.90%,4354,251,561,211,2,1025,426,829,450,4,1709,4354,260,565,210,2,1037,422,808,428,4,1662
Troup,4,93.40%,90.00%,94.50%,92.00%,87.40%,92.20%,2457,22,47,25,0,94,369,424,354,6,1153,2457,28,59,28,2,117,352,411,324,3,1090
Troup,5,78.80%,50.10%,66.50%,78.50%,50.30%,65.60%,2054,170,199,77,3,449,341,200,287,3,831,2054,174,197,76,3,450,335,199,278,3,815
Troup,6,51.60%,27.20%,29.40%,50.00%,27.30%,29.80%,3806,331,1248,235,3,1817,137,467,251,2,857,3806,317,1233,232,3,1785,135,463,232,1,831
Troup,7,32.10%,16.50%,12.80%,28.90%,16.10%,13.40%,3117,605,1031,318,4,1958,86,204,150,3,443,3117,597,1023,327,4,1951,90,197,133,3,423
Troup,8,32.40%,16.00%,11.40%,31.20%,15.70%,12.10%,3893,579,1522,411,3,2515,73,289,197,2,561,3893,564,1514,405,3,2486,77,281,184,1,543
Troup,10,40.30%,19.70%,18.40%,39.70%,19.10%,18.80%,3533,509,1346,270,7,2132,115,331,182,1,629,3533,503,1347,269,7,2126,117,317,177,1,612
Troup,11,44.90%,23.70%,20.40%,44.10%,23.70%,19.80%,3249,606,947,216,3,1772,155,294,176,1,626,3249,602,945,214,3,1764,149,293,169,0,611
Troup,12,50.90%,39.40%,43.40%,50.10%,38.70%,42.40%,2876,236,746,208,5,1195,184,485,216,1,886,2876,240,748,206,5,1199,179,472,207,1,859
Troup,13,53.20%,24.20%,19.40%,51.00%,24.30%,20.00%,1878,458,432,94,7,991,112,138,107,0,357,1878,450,426,94,6,976,114,137,98,0,349
Troup,15,66.70%,51.00%,48.50%,67.50%,49.80%,48.00%,1686,119,304,88,0,511,110,317,176,2,605,1686,118,308,80,0,506,107,305,166,2,580
Troup,16,54.20%,36.40%,49.40%,53.70%,34.40%,47.90%,2600,197,654,187,4,1042,194,374,221,2,791,2600,197,672,180,5,1054,185,352,209,1,747
Turner,1,66.00%,47.00%,68.50%,63.40%,45.10%,67.50%,3509,135,763,127,0,1025,293,677,246,1,1217,3509,135,779,131,0,1045,279,639,227,1,1146
Turner,2,24.30%,10.20%,18.30%,24.80%,10.90%,20.50%,1609,124,829,81,1,1035,28,94,26,0,148,1609,119,807,79,1,1006,31,99,26,0,156
Turner,3,40.50%,10.40%,8.50%,40.00%,9.30%,9.70%,464,118,146,25,0,289,11,17,17,0,45,464,112,147,24,0,283,12,15,16,0,43
Twiggs,DB,35.00%,18.90%,12.40%,34.30%,19.80%,15.50%,1550,311,351,119,0,781,44,82,64,0,190,1550,290,337,117,0,744,53,83,61,0,197
Twiggs,GI,81.60%,53.20%,46.50%,80.60%,53.10%,48.30%,1692,189,238,57,0,484,163,271,252,1,687,1692,179,233,57,0,469,166,264,237,1,668
Twiggs,HV,41.20%,29.10%,16.70%,41.20%,27.90%,17.30%,758,165,185,60,0,410,33,76,42,0,151,758,158,186,57,0,401,33,72,40,0,145
Twiggs,JV/W,87.60%,55.30%,54.80%,84.20%,54.80%,52.20%,1464,94,270,37,0,401,111,334,262,3,710,1464,97,269,45,0,411,105,326,239,1,671
Twiggs,SG/T,75.80%,39.70%,47.80%,73.20%,41.50%,47.10%,840,82,175,37,0,294,75,115,116,0,306,840,83,165,40,0,288,74,117,109,0,300
Union,1,36.50%,14.00%,7.00%,34.90%,13.90%,9.00%,2435,263,933,319,3,1518,20,152,183,0,355,2435,251,904,309,3,1467,25,146,166,0,337
Union,2,31.90%,12.30%,5.20%,30.70%,12.20%,6.60%,2294,399,930,246,0,1575,22,131,115,0,268,2294,384,916,230,0,1530,27,127,102,0,256
Union,3,38.70%,15.20%,7.80%,37.00%,15.10%,7.50%,1377,272,497,138,1,908,23,89,87,0,199,1377,272,489,136,1,898,22,87,80,0,189
Union,4,34.30%,14.40%,8.40%,35.00%,13.30%,7.00%,1945,404,704,232,2,1342,37,118,121,0,276,1945,398,703,221,2,1324,30,108,119,0,257
Union,5,41.30%,16.50%,8.40%,39.70%,16.00%,8.80%,1517,241,536,185,0,962,22,106,130,0,258,1517,238,534,185,0,957,23,102,122,0,247
Union,6,31.40%,13.80%,5.80%,27.20%,13.40%,6.80%,2008,373,760,267,0,1400,23,122,122,0,267,2008,359,743,268,0,1370,26,115,100,0,241
Union,7,44.40%,16.30%,10.70%,45.50%,16.00%,9.90%,611,234,87,60,0,381,28,17,48,0,93,611,227,84,55,0,366,25,16,46,0,87
Union,8,41.00%,17.30%,8.10%,35.20%,16.00%,8.10%,1110,192,388,118,0,698,17,81,82,0,180,1110,194,388,127,0,709,17,74,69,0,160
Union,9,43.40%,17.40%,11.40%,40.50%,18.00%,10.90%,1531,324,469,155,2,950,42,99,119,0,260,1531,318,459,157,2,936,39,101,107,0,247
Union,10,33.60%,12.90%,7.00%,30.80%,12.70%,6.20%,2143,382,785,261,1,1429,29,116,132,0,277,2143,375,773,249,1,1398,25,112,111,0,248
Union,11,39.50%,15.40%,10.40%,37.30%,15.50%,9.50%,2230,316,919,251,2,1488,37,167,164,0,368,2230,311,908,247,2,1468,33,167,147,0,347
Upson,588,63.00%,16.20%,15.70%,63.70%,16.60%,16.10%,1347,350,366,67,0,783,65,71,114,0,250,1347,344,361,62,0,767,66,72,109,0,247
Upson,589,93.00%,78.60%,83.10%,92.90%,79.20%,85.00%,370,14,21,9,0,44,69,77,120,0,266,370,12,20,9,0,41,68,76,118,0,262
Upson,1610,43.80%,15.10%,22.00%,42.70%,15.10%,20.80%,8219,600,3486,628,3,4717,170,621,489,0,1280,8219,595,3450,621,2,4668,157,612,462,0,1231
Upson,5610,64.30%,35.70%,45.90%,62.20%,34.30%,44.40%,8239,400,2190,471,3,3064,342,1214,849,0,2405,8239,404,2207,478,3,3092,325,1150,785,0,2260
Walker,871,38.20%,15.70%,13.50%,38.10%,15.40%,15.50%,6547,725,2056,543,1,3325,113,383,336,0,832,6547,681,2009,509,1,3200,125,366,313,0,804
Walker,917,27.40%,9.00%,6.30%,26.00%,9.60%,7.30%,2212,434,776,175,0,1385,29,77,66,0,172,2212,420,753,168,0,1341,33,80,59,0,172
Walker,944,32.70%,11.90%,10.90%,30.80%,11.70%,12.20%,6275,672,2613,546,0,3831,82,353,265,0,700,6275,646,2572,535,0,3753,90,340,238,0,668
Walker,953,43.40%,16.20%,8.90%,41.70%,15.00%,8.80%,1453,560,244,81,0,885,55,47,62,0,164,1453,546,238,81,0,865,53,42,58,0,153
Walker,1161,41.20%,18.50%,12.00%,39.50%,17.80%,11.10%,1254,381,225,107,1,714,52,51,75,0,178,1254,385,221,104,1,711,48,48,68,0,164
Walker,1501,41.30%,16.20%,19.20%,40.20%,15.80%,17.40%,6325,783,2075,582,2,3442,187,400,409,0,996,6325,782,2038,563,1,3384,164,383,379,1,927
Walker,1809,45.50%,20.40%,12.00%,45.30%,19.90%,11.80%,1347,350,316,84,1,751,47,81,70,1,199,1347,350,306,81,1,738,46,76,67,1,190
Walker,1812,42.30%,18.60%,28.40%,40.00%,19.20%,28.20%,6255,494,1737,479,0,2710,195,396,351,1,943,6255,473,1676,463,0,2612,185,399,309,1,894
Walker,1818,36.20%,12.20%,14.30%,33.90%,11.80%,13.80%,6890,641,2839,608,1,4089,107,394,345,0,846,6890,622,2792,596,1,4011,100,374,306,0,780
Walker,1851,54.20%,34.40%,21.60%,47.10%,31.00%,14.80%,1265,145,378,70,0,593,40,198,83,0,321,1265,155,399,81,0,635,27,179,72,0,278
Walker,1893,37.30%,18.40%,18.80%,35.40%,19.70%,18.20%,3101,375,830,242,2,1449,87,187,144,0,418,3101,363,801,234,2,1400,81,196,128,0,405
Walton,250,36.50%,15.50%,14.50%,34.90%,14.80%,15.10%,4653,686,1766,515,2,2969,117,325,296,0,738,4653,677,1769,514,2,2962,121,308,275,0,704
Walton,1663,27.70%,9.90%,9.80%,26.80%,9.10%,8.80%,1254,240,501,133,0,874,26,55,51,0,132,1254,239,501,131,0,871,23,50,48,0,121
Walton,1675,32.80%,12.80%,15.80%,31.80%,13.10%,14.80%,3858,516,1440,392,0,2348,97,211,191,0,499,3858,513,1423,382,0,2318,89,215,178,0,482
Walton,414,32.20%,9.20%,6.60%,32.30%,8.40%,8.40%,1243,328,433,135,0,896,23,44,64,0,131,1243,315,439,128,0,882,29,40,61,0,130
Walton,415,35.40%,15.60%,17.20%,34.80%,15.20%,15.40%,4925,535,2089,488,1,3113,111,385,267,0,763,4925,537,2082,471,1,3091,98,373,251,0,722
Walton,416,34.50%,13.90%,7.20%,32.00%,13.60%,7.60%,2661,501,925,203,0,1629,39,149,107,0,295,2661,488,922,202,0,1612,40,145,95,0,280
Walton,417,40.60%,24.60%,23.10%,40.30%,24.30%,22.20%,5225,495,1584,476,4,2559,150,518,325,0,993,5225,486,1570,454,4,2514,140,505,307,0,952
Walton,418,49.70%,23.20%,22.80%,47.30%,23.20%,24.50%,4604,722,1295,327,3,2347,213,391,323,1,928,4604,698,1281,332,2,2313,227,387,298,0,912
Walton,419,41.00%,26.40%,28.20%,39.20%,26.10%,27.60%,3910,265,1191,323,0,1779,104,427,224,0,755,3910,260,1180,306,0,1746,99,416,197,0,712
Walton,420,68.40%,47.50%,49.80%,68.30%,47.90%,48.90%,4818,298,776,236,1,1311,294,703,512,3,1512,4818,293,758,223,1,1275,278,696,481,3,1458
Walton,421,42.00%,26.50%,33.30%,38.90%,26.30%,32.70%,3768,326,1096,375,0,1797,163,395,272,0,830,3768,323,1079,375,0,1777,157,386,239,0,782
Walton,422,34.30%,19.20%,15.70%,31.90%,18.90%,14.60%,4219,551,1584,429,0,2564,103,376,224,0,703,4219,543,1570,431,0,2544,93,367,202,0,662
Walton,423,38.30%,15.40%,9.90%,37.40%,14.90%,10.90%,4380,571,1660,385,0,2616,63,303,239,0,605,4380,549,1647,374,0,2570,67,289,223,0,579
Walton,424,36.80%,14.90%,15.40%,35.00%,14.70%,14.80%,3401,339,1392,332,1,2064,62,243,193,0,498,3401,340,1385,333,1,2059,59,238,179,0,476
Walton,425,52.90%,35.90%,38.30%,52.10%,35.40%,38.20%,4119,347,819,221,1,1388,212,458,248,4,922,4119,341,804,209,1,1355,207,440,227,4,878
Walton,426,32.90%,16.70%,16.20%,31.90%,15.90%,15.90%,2027,233,839,204,0,1276,45,168,100,0,313,2027,238,839,201,0,1278,45,159,94,0,298
Walton,427,57.00%,43.80%,37.70%,55.50%,43.00%,37.90%,4050,278,1066,288,1,1633,167,831,382,2,1382,4050,274,1068,284,1,1627,167,805,354,1,1327
Walton,454,27.60%,12.00%,13.20%,26.80%,11.90%,14.00%,1657,277,594,155,0,1026,42,81,59,0,182,1657,271,585,150,0,1006,44,79,55,0,178
Walton,502,24.90%,10.40%,4.80%,23.00%,10.80%,6.10%,1970,659,589,163,1,1412,33,68,54,0,155,1970,644,584,161,0,1389,42,71,48,0,161
Walton,503,28.70%,10.80%,6.90%,27.90%,10.30%,8.20%,1115,404,315,97,0,816,29,38,39,1,107,1115,393,313,93,0,799,34,36,36,1,107
Walton,559,35.30%,13.90%,7.60%,31.90%,13.90%,7.30%,2149,631,640,154,0,1425,52,103,84,0,239,2149,621,632,158,0,1411,49,102,74,0,225
Ware,100,86.40%,77.90%,73.30%,84.50%,75.40%,70.10%,4740,86,260,133,0,479,229,918,847,7,2001,4740,90,277,142,0,509,204,847,774,7,1832
Ware,200A,50.00%,30.90%,34.30%,47.10%,30.20%,33.10%,2730,181,724,154,3,1062,87,324,154,9,574,2730,183,725,153,3,1064,83,313,136,9,541
Ware,200B,68.40%,55.50%,48.70%,68.90%,53.70%,45.50%,976,37,117,49,3,206,38,146,106,0,290,976,39,119,46,3,207,35,138,102,0,275
Ware,300,37.60%,19.10%,22.30%,35.20%,17.70%,22.60%,4061,364,1394,323,6,2087,99,329,195,7,630,4061,353,1385,316,6,2060,97,298,172,8,575
Ware,304,36.40%,11.80%,8.10%,41.30%,11.90%,8.80%,1269,191,417,70,1,679,17,56,40,0,113,1269,186,409,61,1,657,18,55,43,0,116
Ware,400,29.30%,11.50%,8.50%,26.70%,12.00%,9.20%,3538,414,1471,323,4,2212,36,191,134,3,364,3538,402,1447,321,4,2174,38,198,117,3,356
Ware,404,31.90%,4.20%,3.60%,31.90%,5.60%,3.60%,373,161,69,32,1,263,6,3,15,0,24,373,162,67,32,1,262,6,4,15,0,25
Ware,405,15.50%,3.90%,2.80%,13.80%,3.50%,2.80%,636,209,195,49,1,454,6,8,9,0,23,636,204,193,50,1,448,6,7,8,0,21
Ware,406,20.00%,7.80%,6.30%,19.40%,7.90%,7.30%,1659,294,660,112,1,1067,20,56,28,0,104,1659,291,654,112,1,1058,23,56,27,0,106
Ware,407,15.60%,4.30%,3.30%,16.70%,4.20%,3.40%,505,202,110,27,0,339,7,5,5,0,17,505,201,113,25,0,339,7,5,5,0,17
Ware,408,20.70%,5.40%,2.70%,22.20%,5.40%,2.80%,523,214,122,23,0,359,6,7,6,0,19,523,211,122,21,0,354,6,7,6,0,19
Ware,409,18.90%,6.00%,5.10%,18.20%,6.60%,5.70%,984,224,361,73,0,658,12,23,17,0,52,984,216,353,72,0,641,13,25,16,0,54
Warren,1,72.50%,45.00%,61.00%,71.00%,44.50%,60.50%,3785,190,771,205,0,1166,297,632,540,0,1469,3785,190,767,204,0,1161,291,616,500,0,1407
Washington,1253,67.00%,25.40%,22.40%,60.40%,25.50%,23.60%,561,141,103,36,1,281,41,35,73,0,149,561,136,102,40,0,278,41,35,61,1,138
Washington,1350,63.10%,39.30%,33.70%,60.40%,37.30%,31.90%,742,173,99,55,0,327,87,64,94,1,246,742,171,101,59,0,331,79,60,90,1,230
Washington,1488,74.60%,50.20%,60.20%,72.50%,50.70%,58.80%,2512,165,453,108,0,726,247,457,317,3,1024,2512,167,438,111,0,716,235,450,292,3,980
Washington,88,75.50%,47.10%,33.00%,75.00%,45.70%,32.60%,581,128,73,26,0,227,62,65,80,1,208,581,124,75,25,0,224,59,63,75,1,198
Washington,91,63.60%,24.50%,27.90%,65.50%,23.40%,28.30%,1005,218,219,55,2,494,85,71,96,0,252,1005,211,216,50,2,479,84,66,95,0,245
Washington,94,62.70%,27.60%,43.10%,64.80%,27.50%,41.70%,814,144,160,50,0,354,109,61,84,0,254,814,137,158,43,0,338,98,60,79,0,237
Washington,97,73.60%,45.60%,56.90%,71.00%,44.70%,55.70%,6221,314,1265,362,1,1942,416,1059,1011,0,2486,6221,314,1267,375,1,1957,396,1024,917,0,2337
Washington,99,67.50%,26.50%,10.80%,65.80%,27.60%,12.50%,554,198,86,27,1,312,24,31,56,0,111,554,195,84,27,1,307,28,32,52,0,112
Wayne,1A,30.60%,6.80%,4.30%,28.70%,7.60%,5.00%,1260,310,510,86,0,906,14,37,38,0,89,1260,301,499,82,0,882,16,41,33,0,90
Wayne,1B,16.40%,4.90%,5.80%,20.40%,5.90%,7.00%,1176,180,538,127,0,845,10,28,25,1,64,1176,174,525,117,0,816,12,33,30,1,76
Wayne,1C,29.60%,10.70%,9.00%,25.00%,11.30%,11.80%,1741,232,720,140,0,1092,23,86,59,0,168,1741,224,709,144,0,1077,30,90,48,0,168
Wayne,2A,28.80%,12.50%,11.10%,26.10%,12.30%,10.00%,1849,462,600,126,2,1190,58,86,51,0,195,1849,459,593,122,2,1176,51,83,43,0,177
Wayne,2C,18.90%,6.70%,7.40%,19.60%,6.80%,8.20%,1106,189,516,90,0,795,15,37,21,0,73,1106,180,505,86,0,771,16,37,21,0,74
Wayne,2D,33.60%,16.70%,12.70%,31.90%,17.40%,13.80%,1036,131,355,79,0,565,19,71,40,0,130,1036,125,341,77,0,543,20,72,36,0,128
Wayne,3A,36.30%,19.50%,23.50%,39.10%,19.80%,23.40%,2857,225,972,179,3,1379,70,236,102,0,408,2857,221,957,162,2,1342,68,237,104,0,409
Wayne,3B,20.90%,8.20%,6.10%,22.70%,7.80%,6.90%,1123,291,334,110,2,737,19,30,29,0,78,1123,281,333,102,2,718,21,28,30,0,79
Wayne,4A,79.00%,74.60%,78.00%,80.90%,74.60%,73.70%,1145,22,99,35,0,156,77,290,132,1,500,1145,26,96,30,0,152,72,282,127,1,482
Wayne,4B,46.00%,44.50%,51.60%,46.20%,42.40%,52.00%,1140,62,259,74,0,395,66,208,63,0,337,1140,61,266,70,0,397,66,196,60,0,322
Wayne,5A,38.60%,24.60%,23.30%,38.30%,25.50%,25.50%,1905,184,613,170,0,967,56,200,107,0,363,1905,172,597,163,0,932,59,204,101,0,364
Wayne,5B,33.30%,22.60%,13.80%,36.50%,22.90%,14.80%,1766,207,615,138,0,960,33,180,69,0,282,1766,202,601,125,0,928,35,179,72,0,286
Webster,P1,65.20%,35.60%,50.50%,63.80%,36.10%,50.90%,1705,139,488,121,0,748,142,270,227,0,639,1705,136,478,122,0,736,141,270,215,0,626
Wheeler,1,54.00%,25.50%,37.40%,53.20%,24.10%,34.70%,0,201,596,109,0,906,120,204,128,0,452,0,205,592,108,0,905,109,188,123,0,420
Wheeler,2,41.90%,21.10%,24.50%,44.50%,22.40%,23.20%,0,237,347,93,0,677,77,93,67,0,237,0,239,332,86,0,657,72,96,69,0,237
White,11,41.70%,16.80%,7.90%,39.40%,16.70%,7.20%,2352,408,768,236,0,1412,35,155,169,0,359,2352,398,766,237,0,1401,31,154,154,0,339
White,21,24.40%,11.60%,8.40%,22.20%,12.00%,6.90%,929,173,267,118,1,559,16,35,38,0,89,929,174,265,112,1,552,13,36,32,0,81
White,31,41.10%,26.90%,17.50%,39.80%,26.40%,15.20%,609,118,136,53,0,307,25,50,37,0,112,609,117,134,50,0,301,21,48,33,0,102
White,41,24.70%,9.20%,7.10%,24.00%,8.70%,8.30%,3164,612,1066,299,0,1977,47,108,98,0,253,3164,598,1055,285,0,1938,54,100,90,0,244
White,51,30.60%,15.10%,10.60%,28.30%,14.70%,11.50%,4468,530,1554,463,2,2549,63,277,204,0,544,4468,523,1544,455,2,2524,68,266,180,0,514
White,61,44.60%,24.10%,23.00%,39.90%,22.40%,21.80%,1552,207,464,194,1,866,62,147,156,0,365,1552,204,468,206,1,879,57,135,137,0,329
White,71,34.50%,22.60%,15.40%,35.70%,22.70%,14.30%,407,104,103,38,0,245,19,30,20,0,69,407,102,99,36,0,237,17,29,20,0,66
White,81,25.00%,8.80%,6.10%,24.80%,8.10%,8.70%,2538,448,788,228,0,1464,29,76,76,0,181,2538,442,779,218,0,1439,42,69,72,0,183
White,91,27.30%,16.20%,11.70%,25.90%,15.20%,12.20%,1231,196,403,144,0,743,26,78,54,0,158,1231,187,406,140,0,733,26,73,49,0,148
White,101,35.20%,11.70%,8.30%,33.80%,11.70%,9.00%,1593,298,512,136,2,948,27,68,74,0,169,1593,291,505,131,2,929,29,67,67,0,163
White,111,20.80%,6.40%,6.10%,20.40%,5.80%,5.70%,1779,354,619,179,0,1152,23,42,47,0,112,1779,350,613,176,0,1139,21,38,45,0,104
Whitfield,1A,53.00%,51.40%,50.00%,51.30%,50.70%,46.80%,2533,175,316,157,3,651,178,334,177,0,689,2533,180,311,151,3,645,161,320,159,0,640
Whitfield,2A,44.00%,27.90%,30.90%,39.80%,27.20%,31.10%,3090,322,881,243,5,1451,145,341,191,1,678,3090,319,884,253,5,1461,145,330,167,1,643
Whitfield,3A,50.00%,33.30%,29.90%,45.50%,31.20%,29.00%,2221,232,563,179,0,974,99,281,179,0,559,2221,238,575,188,0,1001,97,261,157,0,515
Whitfield,4A,48.80%,33.40%,38.50%,45.10%,31.40%,37.50%,2586,254,709,206,0,1169,158,355,196,1,710,2586,255,722,208,0,1185,152,330,171,1,654
Whitfield,5A,70.20%,72.30%,64.80%,72.20%,70.70%,63.60%,2238,135,145,64,2,346,249,379,151,3,782,2238,133,149,57,2,341,233,360,148,3,744
Whitfield,6A,68.90%,70.30%,66.30%,66.70%,67.80%,68.50%,1690,104,112,42,1,259,206,265,93,1,565,1690,95,117,40,0,252,205,246,80,2,533
Whitfield,AN,59.00%,46.50%,41.50%,59.00%,46.10%,42.10%,2474,232,362,94,5,693,167,315,135,1,618,2474,221,355,86,5,667,163,304,124,1,592
Whitfield,CA,33.80%,20.80%,14.80%,35.60%,22.20%,16.30%,1953,483,392,104,1,980,82,103,53,2,240,1953,462,372,96,1,931,88,106,53,2,249
Whitfield,CO,41.50%,16.30%,11.40%,39.10%,17.20%,11.30%,1431,446,308,83,7,844,57,60,59,1,177,1431,432,299,81,7,819,56,62,52,0,170
Whitfield,DG,43.40%,28.50%,27.80%,41.30%,26.30%,28.10%,3295,508,782,248,4,1542,197,311,190,0,698,3295,493,795,242,4,1534,194,284,170,0,648
Whitfield,ES,55.10%,31.10%,32.30%,51.90%,31.40%,31.20%,1702,233,310,75,0,618,111,140,92,0,343,1702,232,301,76,0,609,105,138,82,0,325
Whitfield,FI,43.70%,30.40%,20.90%,46.60%,30.10%,21.80%,2146,406,468,107,2,983,108,204,83,0,395,2146,390,457,95,2,944,109,197,83,0,389
Whitfield,GL,51.60%,33.90%,36.80%,46.90%,33.80%,37.10%,2510,342,521,140,1,1004,199,267,149,1,616,2510,329,508,146,1,984,194,259,129,1,583
Whitfield,LT,27.10%,13.30%,7.50%,26.50%,12.40%,6.60%,1148,282,405,70,1,758,22,62,26,1,111,1148,282,401,72,1,756,19,57,26,1,103
Whitfield,MC,33.80%,13.40%,7.40%,37.60%,13.20%,8.90%,1659,478,480,102,1,1061,38,74,52,0,164,1659,461,473,88,1,1023,45,72,53,0,170
Whitfield,NI,32.90%,14.60%,11.90%,33.20%,13.40%,13.40%,2456,611,647,171,1,1430,82,111,84,1,278,2456,589,644,159,1,1393,90,100,79,1,270
Whitfield,PG,40.60%,22.80%,28.50%,40.20%,22.40%,28.00%,4721,599,1393,380,4,2376,236,411,260,4,911,4721,583,1364,360,4,2311,225,394,242,3,864
Whitfield,TH,42.00%,18.40%,13.40%,39.80%,18.60%,14.10%,3836,715,1095,260,2,2072,111,247,188,0,546,3836,685,1082,251,2,2020,113,248,166,0,527
Whitfield,TI,37.30%,15.60%,11.00%,40.80%,17.60%,12.50%,775,268,130,32,0,430,32,24,19,1,76,775,258,122,29,0,409,36,26,20,1,83
Whitfield,TR,30.30%,9.70%,9.10%,33.50%,10.20%,10.30%,1335,339,446,115,0,900,34,48,50,0,132,1335,330,441,105,0,876,38,50,53,0,141
Whitfield,UT,34.00%,10.00%,10.00%,34.30%,10.10%,12.10%,1053,362,251,70,0,683,40,28,36,0,104,1053,343,249,67,0,659,47,28,35,0,110
Whitfield,VA,39.40%,20.60%,15.90%,37.70%,20.80%,15.70%,5250,952,1587,378,2,2919,181,411,246,0,838,5250,937,1561,374,2,2874,175,411,226,0,812
Whitfield,WS,36.90%,22.40%,14.50%,34.90%,21.80%,14.30%,2647,485,781,224,3,1493,82,226,131,1,440,2647,466,775,220,3,1464,77,216,118,1,412
Wilcox,1A,70.90%,67.60%,77.20%,74.00%,66.40%,80.60%,558,29,47,16,0,92,98,98,39,0,235,558,24,48,13,0,85,100,95,37,0,232
Wilcox,2A,50.90%,23.10%,33.30%,41.20%,21.80%,35.10%,441,40,206,26,0,272,20,62,27,0,109,441,37,205,30,0,272,20,57,21,0,98
Wilcox,2B,58.80%,33.30%,43.20%,53.50%,34.10%,39.80%,630,121,110,33,0,264,92,55,47,0,194,630,121,108,33,0,262,80,56,38,0,174
Wilcox,3A,26.00%,10.30%,8.50%,23.90%,10.40%,9.60%,876,258,234,71,0,563,24,27,25,0,76,876,254,233,67,0,554,27,27,21,0,75
Wilcox,4A,17.20%,11.10%,14.40%,15.00%,10.60%,15.50%,1033,178,369,111,0,658,30,46,23,0,99,1033,175,363,108,0,646,32,43,19,0,94
Wilcox,5A,37.20%,18.00%,15.20%,34.10%,16.40%,14.00%,1123,117,351,86,0,554,21,77,51,0,149,1123,117,346,87,0,550,19,68,45,0,132
Wilkes,1,77.30%,53.50%,71.20%,74.50%,52.00%,70.10%,1552,58,263,67,1,389,142,303,228,4,677,1552,59,264,69,1,393,138,286,202,3,629
Wilkes,2A,31.30%,19.10%,27.10%,30.70%,18.10%,23.80%,1173,123,441,145,1,710,46,104,66,0,216,1173,124,442,140,1,707,39,98,62,0,199
Wilkes,2B,56.00%,19.00%,20.10%,56.30%,18.40%,18.00%,610,107,170,51,0,328,27,40,65,0,132,610,109,169,49,0,327,24,38,63,0,125
Wilkes,3A,80.10%,63.60%,78.40%,78.10%,63.50%,76.50%,1017,40,120,32,0,192,145,210,129,0,484,1017,42,119,33,0,194,137,207,118,0,462
Wilkes,3B,63.50%,28.00%,22.50%,65.50%,27.90%,22.50%,570,130,113,31,1,275,38,44,54,0,136,570,130,111,29,1,271,38,43,55,0,136
Wilkes,4A,52.00%,27.40%,31.90%,52.60%,27.20%,34.20%,1001,81,332,85,0,498,38,125,92,0,255,1001,75,329,82,0,486,39,123,91,0,253
Wilkes,4B,68.40%,25.30%,29.20%,67.80%,24.50%,28.80%,896,165,210,56,0,431,68,71,121,0,260,896,166,210,56,0,432,67,68,118,0,253
Wilkinson,2,32.40%,12.90%,5.00%,35.50%,11.20%,7.10%,434,191,101,23,0,315,10,15,11,0,36,434,183,103,20,0,306,14,13,11,0,38
Wilkinson,3,50.00%,13.50%,14.00%,53.80%,13.90%,14.10%,184,80,32,13,0,125,13,5,13,0,31,184,79,31,12,0,122,13,5,14,0,32
Wilkinson,4,46.70%,25.60%,12.00%,38.50%,29.30%,13.30%,173,73,29,8,0,110,10,10,7,0,27,173,72,29,8,0,109,11,12,5,0,28
Wilkinson,5,83.20%,51.50%,35.80%,84.40%,51.00%,37.10%,875,76,196,22,1,295,43,208,109,0,360,875,72,191,19,1,283,43,199,103,0,345
Wilkinson,6,30.40%,15.90%,9.20%,30.80%,16.70%,10.90%,960,303,196,48,2,549,31,37,21,0,89,960,300,190,45,2,537,37,38,20,0,95
Wilkinson,7,70.10%,39.80%,32.90%,74.40%,37.90%,33.20%,735,149,139,29,0,317,73,92,68,0,233,735,145,141,23,0,309,72,86,67,0,225
Wilkinson,8,93.30%,76.20%,77.80%,93.50%,74.80%,76.20%,938,28,80,13,0,121,95,256,180,3,534,938,30,83,12,0,125,93,246,174,3,516
Wilkinson,10,68.70%,51.70%,46.20%,66.70%,51.80%,45.60%,1709,241,263,81,0,585,207,282,178,0,667,1709,236,260,82,0,578,198,279,164,0,641
Wilkinson,11,40.50%,33.60%,23.20%,48.60%,33.60%,22.70%,462,152,73,22,0,247,46,37,15,0,98,462,150,71,18,0,239,44,36,17,0,97
Worth,1,80.00%,52.80%,67.00%,78.90%,52.00%,66.60%,3006,118,412,86,0,616,240,461,344,0,1045,3006,117,410,88,0,615,233,444,329,0,1006
Worth,2,26.70%,5.10%,3.90%,25.00%,5.30%,3.40%,603,199,148,33,0,380,8,8,12,0,28,603,196,143,33,0,372,7,8,11,0,26
Worth,3,25.00%,6.60%,3.00%,23.90%,4.90%,3.60%,543,192,155,36,0,383,6,11,12,0,29,543,187,155,35,0,377,7,8,11,0,26
Worth,4,34.20%,14.60%,12.10%,31.80%,15.60%,14.40%,1286,299,315,75,0,689,41,54,39,0,134,1286,285,308,75,0,668,48,57,35,0,140
Worth,5,44.00%,15.60%,5.80%,43.00%,17.50%,7.60%,887,178,190,47,0,415,11,35,37,0,83,887,171,179,45,0,395,14,38,34,0,86
Worth,6,21.60%,12.20%,8.90%,20.30%,12.30%,9.20%,1424,267,503,109,0,879,26,70,30,0,126,1424,267,500,106,0,873,27,70,27,0,124
Worth,7,56.80%,39.40%,30.40%,54.30%,38.20%,34.30%,336,48,63,16,0,127,21,41,21,0,83,336,44,63,16,0,123,23,39,19,0,81
Worth,8,42.90%,20.90%,18.00%,41.40%,19.90%,16.40%,1406,173,443,93,0,709,38,117,70,0,225,1406,173,443,92,0,708,34,110,65,0,209
Worth,9,41.70%,16.80%,13.30%,41.70%,17.00%,12.70%,887,228,208,49,0,485,35,42,35,0,112,887,226,205,49,0,480,33,42,35,0,110
Worth,10,47.30%,16.00%,13.00%,47.20%,16.20%,12.80%,871,220,194,48,0,462,33,37,43,0,113,871,218,192,47,0,457,32,37,42,0,111
Worth,11,33.30%,11.00%,4.10%,30.20%,10.00%,4.20%,554,185,154,36,0,375,8,19,18,0,45,554,183,153,37,0,373,8,17,16,0,41
Worth,12,52.10%,16.60%,12.70%,52.60%,17.00%,13.60%,1287,281,247,57,0,585,41,49,62,0,152,1287,273,239,55,0,567,43,49,61,0,153
Worth,14,20.90%,13.90%,3.70%,25.00%,15.90%,4.30%,449,157,93,34,0,284,6,15,9,0,30,449,157,90,30,0,277,7,17,10,0,34
Worth,15,81.30%,28.10%,8.10%,81.30%,24.60%,11.50%,229,57,41,6,0,104,5,16,26,0,47,229,54,43,6,0,103,7,14,26,0,47
Worth,16,60.20%,13.80%,25.90%,59.40%,11.90%,24.30%,701,177,119,41,0,337,62,19,62,0,143,701,178,119,41,0,338,57,16,60,0,133